"Geography_Code","NM_1287_1_0","NM_1287_1_1","NM_1287_1_10","NM_1287_1_11","NM_1287_1_12","NM_1287_1_13","NM_1287_1_14","NM_1287_1_15","NM_1287_1_16","NM_1287_1_17","NM_1287_1_18","NM_1287_1_19","NM_1287_1_2","NM_1287_1_20","NM_1287_1_3","NM_1287_1_4","NM_1287_1_5","NM_1287_1_6","NM_1287_1_7","NM_1287_1_8","NM_1287_1_9"
"N00000001",1113,682,18,324,45,443,93,49,44,0,35,9,431,25,18,359,54,468,1020,633,387
"N00000002",351,326,0,23,2,39,2,2,0,0,0,0,25,0,0,23,2,39,349,324,25
"N00000003",237,236,0,0,1,6,0,0,0,0,0,0,1,0,0,0,1,6,237,236,1
"N00000004",616,588,5,22,1,44,1,1,0,0,0,0,28,0,5,22,1,44,615,587,28
"N00000005",374,348,2,23,1,17,1,1,0,0,0,0,26,0,2,23,1,17,373,347,26
"N00000006",251,243,0,8,0,9,7,7,0,0,0,0,8,0,0,8,0,9,244,236,8
"N00000007",245,234,0,9,0,27,2,0,2,0,1,1,11,0,0,10,1,27,243,234,9
"N00000008",288,259,1,26,1,40,3,2,1,0,0,1,29,0,1,26,2,40,285,257,28
"N00000009",727,657,3,59,6,53,15,13,2,0,2,0,70,0,3,61,6,53,712,644,68
"N00000010",242,235,0,5,2,19,1,1,0,0,0,0,7,0,0,5,2,19,241,234,7
"N00000011",293,275,0,16,1,29,6,5,1,0,1,0,18,1,0,17,1,30,287,270,17
"N00000012",264,245,0,15,3,7,2,1,1,0,1,0,19,0,0,16,3,7,262,244,18
"N00000013",268,246,1,19,1,28,1,0,1,0,0,1,22,0,1,19,2,28,267,246,21
"N00000014",460,389,1,69,0,51,6,5,1,0,1,0,71,0,1,70,0,51,454,384,70
"N00000015",226,208,0,17,0,13,1,0,1,0,1,0,18,1,0,18,0,14,225,208,17
"N00000016",223,197,3,21,1,13,4,3,1,0,0,1,26,0,3,21,2,13,219,194,25
"N00000017",340,306,0,31,3,41,8,8,0,0,0,0,34,0,0,31,3,41,332,298,34
"N00000018",229,198,0,29,0,23,2,0,2,0,1,1,31,6,0,30,1,29,227,198,29
"N00000019",261,243,0,16,1,22,8,7,1,0,0,1,18,0,0,16,2,22,253,236,17
"N00000020",236,211,1,24,0,15,2,2,0,0,0,0,25,0,1,24,0,15,234,209,25
"N00000021",269,240,0,27,2,43,4,4,0,0,0,0,29,0,0,27,2,43,265,236,29
"N00000022",269,236,5,27,0,21,2,1,1,0,0,1,33,0,5,27,1,21,267,235,32
"N00000023",218,207,0,9,2,18,2,2,0,0,0,0,11,0,0,9,2,18,216,205,11
"N00000024",533,517,0,16,0,25,3,3,0,0,0,0,16,0,0,16,0,25,530,514,16
"N00000025",460,435,1,24,0,16,0,0,0,0,0,0,25,2,1,24,0,18,460,435,25
"N00000026",466,442,0,22,2,32,4,4,0,0,0,0,24,3,0,22,2,35,462,438,24
"N00000027",540,514,0,26,0,25,5,5,0,0,0,0,26,0,0,26,0,25,535,509,26
"N00000028",236,223,0,13,0,17,2,2,0,0,0,0,13,0,0,13,0,17,234,221,13
"N00000029",403,376,0,24,2,21,7,6,1,0,1,0,27,0,0,25,2,21,396,370,26
"N00000030",375,341,0,33,1,17,3,3,0,0,0,0,34,0,0,33,1,17,372,338,34
"N00000031",707,668,4,32,3,33,1,1,0,0,0,0,39,2,4,32,3,35,706,667,39
"N00000032",386,370,0,15,1,36,0,0,0,0,0,0,16,0,0,15,1,36,386,370,16
"N00000033",498,460,5,31,0,13,6,4,2,0,2,0,38,0,5,33,0,13,492,456,36
"N00000034",474,441,0,26,7,22,4,4,0,0,0,0,33,0,0,26,7,22,470,437,33
"N00000035",291,279,0,12,0,29,3,3,0,0,0,0,12,0,0,12,0,29,288,276,12
"N00000036",345,315,0,26,4,19,7,7,0,0,0,0,30,2,0,26,4,21,338,308,30
"N00000037",285,279,0,6,0,12,0,0,0,0,0,0,6,0,0,6,0,12,285,279,6
"N00000038",406,367,6,30,0,14,4,1,3,0,1,2,39,1,6,31,2,15,402,366,36
"N00000039",1262,1174,11,71,4,64,28,26,2,0,2,0,88,1,11,73,4,65,1234,1148,86
"N00000040",265,248,0,17,0,25,0,0,0,0,0,0,17,0,0,17,0,25,265,248,17
"N00000041",462,445,0,16,1,22,0,0,0,0,0,0,17,0,0,16,1,22,462,445,17
"N00000042",410,392,0,16,2,22,1,1,0,0,0,0,18,0,0,16,2,22,409,391,18
"N00000043",1245,1169,6,64,1,61,22,17,5,0,5,0,76,2,6,69,1,63,1223,1152,71
"N00000044",312,298,0,13,1,34,0,0,0,0,0,0,14,0,0,13,1,34,312,298,14
"N00000045",515,495,2,18,0,27,2,2,0,0,0,0,20,0,2,18,0,27,513,493,20
"N00000046",394,383,0,11,0,19,0,0,0,0,0,0,11,0,0,11,0,19,394,383,11
"N00000047",374,349,0,23,2,19,2,2,0,0,0,0,25,3,0,23,2,22,372,347,25
"N00000048",304,266,1,30,7,60,4,4,0,0,0,0,38,0,1,30,7,60,300,262,38
"N00000049",254,229,0,20,5,11,2,2,0,0,0,0,25,1,0,20,5,12,252,227,25
"N00000050",299,289,0,10,0,35,0,0,0,0,0,0,10,0,0,10,0,35,299,289,10
"N00000051",313,270,1,42,0,15,7,7,0,0,0,0,43,1,1,42,0,16,306,263,43
"N00000052",309,284,1,19,5,20,3,3,0,0,0,0,25,0,1,19,5,20,306,281,25
"N00000053",261,232,0,15,12,27,7,5,2,0,2,0,29,0,0,17,12,27,254,227,27
"N00000054",266,244,0,21,1,29,3,3,0,0,0,0,22,0,0,21,1,29,263,241,22
"N00000055",266,261,0,5,0,19,4,4,0,0,0,0,5,0,0,5,0,19,262,257,5
"N00000056",283,265,0,18,0,29,0,0,0,0,0,0,18,0,0,18,0,29,283,265,18
"N00000057",279,251,0,25,2,27,4,3,1,0,1,0,28,3,0,26,2,30,275,248,27
"N00000058",266,245,0,19,1,19,20,19,1,0,1,0,21,1,0,20,1,20,246,226,20
"N00000059",226,202,0,23,1,20,8,8,0,0,0,0,24,5,0,23,1,25,218,194,24
"N00000060",394,362,0,30,0,46,17,15,2,0,2,0,32,4,0,32,0,50,377,347,30
"N00000061",273,262,0,11,0,26,19,19,0,0,0,0,11,4,0,11,0,30,254,243,11
"N00000062",351,328,0,22,1,38,9,9,0,0,0,0,23,2,0,22,1,40,342,319,23
"N00000063",431,384,0,43,3,38,26,25,1,0,1,0,47,7,0,44,3,45,405,359,46
"N00000064",279,247,0,24,4,11,10,6,4,0,3,1,32,0,0,27,5,11,269,241,28
"N00000065",389,380,0,7,2,23,13,13,0,0,0,0,9,1,0,7,2,24,376,367,9
"N00000066",264,243,0,15,0,15,9,3,6,0,3,3,21,1,0,18,3,16,255,240,15
"N00000067",316,288,0,23,5,37,4,4,0,0,0,0,28,1,0,23,5,38,312,284,28
"N00000068",371,355,0,12,4,26,14,14,0,0,0,0,16,0,0,12,4,26,357,341,16
"N00000069",334,310,2,22,0,34,1,1,0,0,0,0,24,0,2,22,0,34,333,309,24
"N00000070",243,237,0,5,1,21,1,1,0,0,0,0,6,1,0,5,1,22,242,236,6
"N00000071",283,242,3,38,0,27,5,5,0,0,0,0,41,2,3,38,0,29,278,237,41
"N00000072",1753,1624,12,94,13,97,40,30,10,0,7,3,129,6,12,101,16,103,1713,1594,119
"N00000073",521,432,2,78,3,49,13,7,6,0,5,1,89,2,2,83,4,51,508,425,83
"N00000074",1047,934,4,83,10,81,66,50,16,0,16,0,113,0,4,99,10,81,981,884,97
"N00000075",410,344,0,63,1,32,4,2,2,0,2,0,66,0,0,65,1,32,406,342,64
"N00000076",344,324,0,15,5,15,9,9,0,0,0,0,20,0,0,15,5,15,335,315,20
"N00000077",275,264,0,8,3,11,3,3,0,0,0,0,11,0,0,8,3,11,272,261,11
"N00000078",488,462,0,24,0,41,49,47,2,0,2,0,26,1,0,26,0,42,439,415,24
"N00000079",564,530,0,33,1,16,2,2,0,0,0,0,34,0,0,33,1,16,562,528,34
"N00000080",424,403,0,20,1,20,1,1,0,0,0,0,21,0,0,20,1,20,423,402,21
"N00000081",339,327,0,11,1,34,1,1,0,0,0,0,12,0,0,11,1,34,338,326,12
"N00000082",342,326,0,16,0,31,0,0,0,0,0,0,16,0,0,16,0,31,342,326,16
"N00000083",650,613,8,25,4,52,2,2,0,0,0,0,37,0,8,25,4,52,648,611,37
"N00000084",456,439,0,17,0,22,1,1,0,0,0,0,17,0,0,17,0,22,455,438,17
"N00000085",437,382,1,46,7,24,7,6,1,0,1,0,55,0,1,47,7,24,430,376,54
"N00000086",395,361,5,29,0,23,3,3,0,0,0,0,34,0,5,29,0,23,392,358,34
"N00000087",913,866,1,34,11,59,4,3,1,0,0,1,47,0,1,34,12,59,909,863,46
"N00000088",216,197,0,18,1,20,5,5,0,0,0,0,19,0,0,18,1,20,211,192,19
"N00000089",478,455,0,22,0,28,5,4,1,0,1,0,23,0,0,23,0,28,473,451,22
"N00000090",392,361,0,29,2,36,3,3,0,0,0,0,31,0,0,29,2,36,389,358,31
"N00000091",476,428,0,40,8,39,5,5,0,0,0,0,48,2,0,40,8,41,471,423,48
"N00000092",504,469,0,32,3,22,1,1,0,0,0,0,35,0,0,32,3,22,503,468,35
"N00000093",421,407,0,14,0,24,5,5,0,0,0,0,14,0,0,14,0,24,416,402,14
"N00000094",492,475,0,13,4,12,3,3,0,0,0,0,17,0,0,13,4,12,489,472,17
"N00000095",468,447,0,18,1,17,2,0,2,0,1,1,21,0,0,19,2,17,466,447,19
"N00000096",464,441,0,21,2,28,0,0,0,0,0,0,23,1,0,21,2,29,464,441,23
"N00000097",850,796,0,45,8,60,23,22,1,0,1,0,54,0,0,46,8,60,827,774,53
"N00000098",1192,1024,9,127,16,106,139,123,16,0,13,3,168,0,9,140,19,106,1053,901,152
"N00000099",258,219,0,34,1,14,6,2,4,0,4,0,39,0,0,38,1,14,252,217,35
"N00000100",341,305,1,30,1,25,15,11,4,0,4,0,36,2,1,34,1,27,326,294,32
"N00000101",282,207,2,68,2,34,18,15,3,0,3,0,75,11,2,71,2,45,264,192,72
"N00000102",318,294,0,19,4,23,17,16,1,0,0,1,24,3,0,19,5,26,301,278,23
"N00000103",623,533,1,83,3,64,20,17,3,0,3,0,90,1,1,86,3,65,603,516,87
"N00000104",322,280,1,37,0,52,27,23,4,1,2,1,42,4,2,39,1,56,295,257,38
"N00000105",327,307,0,15,4,16,10,9,1,0,1,0,20,8,0,16,4,24,317,298,19
"N00000106",198,176,0,20,0,15,12,10,2,0,1,1,22,6,0,21,1,21,186,166,20
"N00000107",269,238,0,29,2,42,1,1,0,0,0,0,31,1,0,29,2,43,268,237,31
"N00000108",243,218,4,19,2,17,3,3,0,0,0,0,25,0,4,19,2,17,240,215,25
"N00000109",512,450,4,52,2,74,10,6,4,0,1,3,62,2,4,53,5,76,502,444,58
"N00000110",258,227,1,26,1,31,6,3,3,0,2,1,31,0,1,28,2,31,252,224,28
"N00000111",356,341,0,13,2,15,12,12,0,0,0,0,15,0,0,13,2,15,344,329,15
"N00000112",402,371,2,27,2,47,9,9,0,0,0,0,31,0,2,27,2,47,393,362,31
"N00000113",309,281,0,22,0,34,10,4,6,0,6,0,28,0,0,28,0,34,299,277,22
"N00000114",318,309,0,9,0,20,8,8,0,0,0,0,9,1,0,9,0,21,310,301,9
"N00000115",302,280,0,18,4,12,12,12,0,0,0,0,22,3,0,18,4,15,290,268,22
"N00000116",287,268,0,15,4,30,5,5,0,0,0,0,19,0,0,15,4,30,282,263,19
"N00000117",168,153,0,15,0,17,0,0,0,0,0,0,15,1,0,15,0,18,168,153,15
"N00000118",333,290,0,29,7,31,19,12,7,0,3,4,43,0,0,32,11,31,314,278,36
"N00000119",289,268,0,17,2,42,4,2,2,0,2,0,21,0,0,19,2,42,285,266,19
"N00000120",323,314,0,9,0,15,0,0,0,0,0,0,9,0,0,9,0,15,323,314,9
"N00000121",293,268,0,24,1,16,3,3,0,0,0,0,25,3,0,24,1,19,290,265,25
"N00000122",481,454,2,16,6,33,12,9,3,0,0,3,27,2,2,16,9,35,469,445,24
"N00000123",351,334,0,14,2,23,7,6,1,0,0,1,17,0,0,14,3,23,344,328,16
"N00000124",369,336,0,32,1,26,4,4,0,0,0,0,33,0,0,32,1,26,365,332,33
"N00000125",464,438,0,26,0,30,1,1,0,0,0,0,26,0,0,26,0,30,463,437,26
"N00000126",481,468,2,11,0,18,0,0,0,0,0,0,13,1,2,11,0,19,481,468,13
"N00000127",405,386,1,17,1,35,5,5,0,0,0,0,19,1,1,17,1,36,400,381,19
"N00000128",991,915,13,50,6,40,9,2,7,0,6,1,76,8,13,56,7,48,982,913,69
"N00000129",346,327,1,15,0,25,9,6,3,0,1,2,19,4,1,16,2,29,337,321,16
"N00000130",498,458,0,39,1,18,9,9,0,0,0,0,40,0,0,39,1,18,489,449,40
"N00000131",388,384,0,4,0,21,6,6,0,0,0,0,4,0,0,4,0,21,382,378,4
"N00000132",366,353,0,12,1,8,2,2,0,0,0,0,13,0,0,12,1,8,364,351,13
"N00000133",322,305,0,16,0,14,2,1,1,0,1,0,17,0,0,17,0,14,320,304,16
"N00000134",437,422,0,14,1,24,1,1,0,0,0,0,15,1,0,14,1,25,436,421,15
"N00000135",312,301,0,11,0,16,2,2,0,0,0,0,11,0,0,11,0,16,310,299,11
"N00000136",507,485,0,21,1,23,9,9,0,0,0,0,22,0,0,21,1,23,498,476,22
"N00000137",315,301,0,14,0,23,1,1,0,0,0,0,14,0,0,14,0,23,314,300,14
"N00000138",464,460,0,3,1,23,1,1,0,0,0,0,4,0,0,3,1,23,463,459,4
"N00000139",301,282,0,18,1,13,5,5,0,0,0,0,19,0,0,18,1,13,296,277,19
"N00000140",333,304,0,27,2,27,0,0,0,0,0,0,29,1,0,27,2,28,333,304,29
"N00000141",443,395,0,41,0,30,7,0,7,0,7,0,48,1,0,48,0,31,436,395,41
"N00000142",205,192,3,10,0,24,0,0,0,0,0,0,13,0,3,10,0,24,205,192,13
"N00000143",215,193,0,22,0,24,2,2,0,0,0,0,22,0,0,22,0,24,213,191,22
"N00000144",228,196,0,32,0,17,1,1,0,0,0,0,32,0,0,32,0,17,227,195,32
"N00000145",124,119,0,5,0,5,0,0,0,0,0,0,5,0,0,5,0,5,124,119,5
"N00000146",271,246,3,18,4,14,0,0,0,0,0,0,25,1,3,18,4,15,271,246,25
"N00000147",227,197,0,27,3,6,4,4,0,0,0,0,30,0,0,27,3,6,223,193,30
"N00000148",676,599,11,65,0,61,3,2,1,0,1,0,77,0,11,66,0,61,673,597,76
"N00000149",432,397,0,34,1,30,2,2,0,0,0,0,35,0,0,34,1,30,430,395,35
"N00000150",365,353,0,11,1,20,5,5,0,0,0,0,12,0,0,11,1,20,360,348,12
"N00000151",283,253,0,30,0,17,1,1,0,0,0,0,30,0,0,30,0,17,282,252,30
"N00000152",270,259,0,9,2,12,1,1,0,0,0,0,11,0,0,9,2,12,269,258,11
"N00000153",250,233,4,8,5,15,1,1,0,0,0,0,17,0,4,8,5,15,249,232,17
"N00000154",259,246,0,11,0,16,2,0,2,0,2,0,13,0,0,13,0,16,257,246,11
"N00000155",337,314,0,23,0,9,3,3,0,0,0,0,23,1,0,23,0,10,334,311,23
"N00000156",301,294,0,6,1,5,1,1,0,0,0,0,7,0,0,6,1,5,300,293,7
"N00000157",368,346,0,22,0,16,3,3,0,0,0,0,22,0,0,22,0,16,365,343,22
"N00000158",678,611,3,62,2,52,5,5,0,0,0,0,67,0,3,62,2,52,673,606,67
"N00000159",221,200,0,18,2,19,3,2,1,0,1,0,21,0,0,19,2,19,218,198,20
"N00000160",322,277,1,42,2,31,2,2,0,0,0,0,45,1,1,42,2,32,320,275,45
"N00000161",342,326,0,15,0,26,7,6,1,0,0,1,16,0,0,15,1,26,335,320,15
"N00000162",242,235,0,7,0,24,6,6,0,0,0,0,7,1,0,7,0,25,236,229,7
"N00000163",311,250,2,59,0,40,0,0,0,0,0,0,61,1,2,59,0,41,311,250,61
"N00000164",288,280,0,8,0,11,0,0,0,0,0,0,8,0,0,8,0,11,288,280,8
"N00000165",325,308,2,15,0,16,1,1,0,0,0,0,17,0,2,15,0,16,324,307,17
"N00000166",273,252,0,16,5,25,5,5,0,0,0,0,21,0,0,16,5,25,268,247,21
"N00000167",379,347,0,32,0,16,2,2,0,0,0,0,32,0,0,32,0,16,377,345,32
"N00000168",345,330,0,15,0,18,0,0,0,0,0,0,15,0,0,15,0,18,345,330,15
"N00000169",704,685,0,18,1,29,12,12,0,0,0,0,19,0,0,18,1,29,692,673,19
"N00000170",370,359,0,7,4,14,3,3,0,0,0,0,11,1,0,7,4,15,367,356,11
"N00000171",416,385,0,29,1,17,8,7,1,0,1,0,31,0,0,30,1,17,408,378,30
"N00000172",772,701,3,63,4,46,16,15,1,0,1,0,71,1,3,64,4,47,756,686,70
"N00000173",373,343,0,28,2,18,0,0,0,0,0,0,30,0,0,28,2,18,373,343,30
"N00000174",393,362,2,29,0,16,5,5,0,0,0,0,31,0,2,29,0,16,388,357,31
"N00000175",373,349,0,21,2,14,4,3,1,0,1,0,24,0,0,22,2,14,369,346,23
"N00000176",474,419,0,49,1,46,18,13,5,0,1,4,55,0,0,50,5,46,456,406,50
"N00000177",323,279,4,34,1,55,13,8,5,0,4,1,44,2,4,38,2,57,310,271,39
"N00000178",667,582,5,77,3,52,8,8,0,0,0,0,85,1,5,77,3,53,659,574,85
"N00000179",852,720,5,119,7,82,15,14,1,0,0,1,132,1,5,119,8,83,837,706,131
"N00000180",280,263,3,14,0,11,0,0,0,0,0,0,17,0,3,14,0,11,280,263,17
"N00000181",274,229,0,39,0,49,16,10,6,0,3,3,45,0,0,42,3,49,258,219,39
"N00000182",228,206,2,20,0,22,1,1,0,0,0,0,22,0,2,20,0,22,227,205,22
"N00000183",293,251,2,38,2,43,20,20,0,0,0,0,42,0,2,38,2,43,273,231,42
"N00000184",372,290,1,79,1,62,4,3,1,0,1,0,82,0,1,80,1,62,368,287,81
"N00000185",211,196,1,13,1,26,0,0,0,0,0,0,15,1,1,13,1,27,211,196,15
"N00000186",299,273,0,25,0,31,5,4,1,0,1,0,26,0,0,26,0,31,294,269,25
"N00000187",255,224,0,31,0,12,0,0,0,0,0,0,31,0,0,31,0,12,255,224,31
"N00000188",347,315,0,32,0,34,4,4,0,0,0,0,32,0,0,32,0,34,343,311,32
"N00000189",341,306,0,34,1,12,0,0,0,0,0,0,35,1,0,34,1,13,341,306,35
"N00000190",304,295,0,9,0,19,2,2,0,0,0,0,9,0,0,9,0,19,302,293,9
"N00000191",303,286,0,17,0,15,3,3,0,0,0,0,17,0,0,17,0,15,300,283,17
"N00000192",302,261,3,35,3,25,2,2,0,0,0,0,41,0,3,35,3,25,300,259,41
"N00000193",291,263,0,28,0,19,3,3,0,0,0,0,28,0,0,28,0,19,288,260,28
"N00000194",255,240,0,15,0,20,0,0,0,0,0,0,15,0,0,15,0,20,255,240,15
"N00000195",246,233,0,13,0,15,0,0,0,0,0,0,13,0,0,13,0,15,246,233,13
"N00000196",237,217,0,18,0,2,6,4,2,0,2,0,20,0,0,20,0,2,231,213,18
"N00000197",326,293,0,21,12,15,7,7,0,0,0,0,33,0,0,21,12,15,319,286,33
"N00000198",287,268,0,17,0,14,7,5,2,0,2,0,19,4,0,19,0,18,280,263,17
"N00000199",350,340,0,9,1,10,1,1,0,0,0,0,10,0,0,9,1,10,349,339,10
"N00000200",331,310,0,21,0,17,11,11,0,0,0,0,21,0,0,21,0,17,320,299,21
"N00000201",294,274,0,19,1,21,0,0,0,0,0,0,20,0,0,19,1,21,294,274,20
"N00000202",304,286,0,18,0,23,0,0,0,0,0,0,18,0,0,18,0,23,304,286,18
"N00000203",334,314,0,18,2,14,6,6,0,0,0,0,20,0,0,18,2,14,328,308,20
"N00000204",393,350,1,36,0,37,10,4,6,0,6,0,43,0,1,42,0,37,383,346,37
"N00000205",303,298,0,4,1,12,0,0,0,0,0,0,5,1,0,4,1,13,303,298,5
"N00000206",390,338,0,49,1,22,3,1,2,0,2,0,52,0,0,51,1,22,387,337,50
"N00000207",253,227,2,21,2,19,1,0,1,0,0,1,26,0,2,21,3,19,252,227,25
"N00000208",316,297,3,14,0,24,4,2,2,0,2,0,19,1,3,16,0,25,312,295,17
"N00000209",356,344,0,12,0,17,1,1,0,0,0,0,12,0,0,12,0,17,355,343,12
"N00000210",383,322,4,51,6,29,15,15,0,0,0,0,61,2,4,51,6,31,368,307,61
"N00000211",528,485,5,32,2,27,32,28,4,0,4,0,43,1,5,36,2,28,496,457,39
"N00000212",175,146,1,23,4,29,2,1,1,0,1,0,29,5,1,24,4,34,173,145,28
"N00000213",281,257,1,22,1,16,8,8,0,0,0,0,24,2,1,22,1,18,273,249,24
"N00000214",323,286,0,35,1,22,16,15,1,0,1,0,37,4,0,36,1,26,307,271,36
"N00000215",400,384,0,16,0,13,1,1,0,0,0,0,16,5,0,16,0,18,399,383,16
"N00000216",397,355,3,39,0,45,1,1,0,0,0,0,42,0,3,39,0,45,396,354,42
"N00000217",479,455,0,19,5,19,0,0,0,0,0,0,24,0,0,19,5,19,479,455,24
"N00000218",361,338,0,22,0,47,6,5,1,0,1,0,23,0,0,23,0,47,355,333,22
"N00000219",245,215,0,29,0,21,13,12,1,0,0,1,30,2,0,29,1,23,232,203,29
"N00000220",284,243,10,30,0,32,2,1,1,0,1,0,41,0,10,31,0,32,282,242,40
"N00000221",262,244,0,18,0,26,0,0,0,0,0,0,18,0,0,18,0,26,262,244,18
"N00000222",298,279,0,17,2,10,2,2,0,0,0,0,19,0,0,17,2,10,296,277,19
"N00000223",319,313,0,6,0,11,0,0,0,0,0,0,6,1,0,6,0,12,319,313,6
"N00000224",243,221,5,14,0,13,3,0,3,0,0,3,22,0,5,14,3,13,240,221,19
"N00000225",147,142,0,5,0,7,0,0,0,0,0,0,5,1,0,5,0,8,147,142,5
"N00000226",261,250,0,8,3,6,0,0,0,0,0,0,11,0,0,8,3,6,261,250,11
"N00000227",195,176,0,19,0,8,1,1,0,0,0,0,19,0,0,19,0,8,194,175,19
"N00000228",306,295,1,7,3,11,0,0,0,0,0,0,11,0,1,7,3,11,306,295,11
"N00000229",395,367,0,27,0,27,8,7,1,0,1,0,28,0,0,28,0,27,387,360,27
"N00000230",293,274,0,17,2,11,6,6,0,0,0,0,19,0,0,17,2,11,287,268,19
"N00000231",324,291,3,30,0,24,6,6,0,0,0,0,33,0,3,30,0,24,318,285,33
"N00000232",309,281,0,20,7,32,14,13,1,0,0,1,28,0,0,20,8,32,295,268,27
"N00000233",258,231,0,26,0,22,7,6,1,0,1,0,27,0,0,27,0,22,251,225,26
"N00000234",256,218,0,38,0,15,8,8,0,0,0,0,38,0,0,38,0,15,248,210,38
"N00000235",323,289,0,33,1,37,1,1,0,0,0,0,34,0,0,33,1,37,322,288,34
"N00000236",291,278,0,13,0,15,5,5,0,0,0,0,13,0,0,13,0,15,286,273,13
"N00000237",416,405,0,11,0,18,1,1,0,0,0,0,11,0,0,11,0,18,415,404,11
"N00000238",306,292,0,14,0,16,1,1,0,0,0,0,14,0,0,14,0,16,305,291,14
"N00000239",254,235,0,17,0,29,3,1,2,0,2,0,19,0,0,19,0,29,251,234,17
"N00000240",354,316,3,34,1,33,1,1,0,0,0,0,38,0,3,34,1,33,353,315,38
"N00000241",424,406,0,16,1,7,6,5,1,0,0,1,18,0,0,16,2,7,418,401,17
"N00000242",360,352,0,7,1,17,1,1,0,0,0,0,8,0,0,7,1,17,359,351,8
"N00000243",265,254,0,8,3,10,0,0,0,0,0,0,11,0,0,8,3,10,265,254,11
"N00000244",275,258,0,17,0,24,3,3,0,0,0,0,17,2,0,17,0,26,272,255,17
"N00000245",314,303,0,7,4,21,11,11,0,0,0,0,11,0,0,7,4,21,303,292,11
"N00000246",309,286,1,22,0,18,2,2,0,0,0,0,23,0,1,22,0,18,307,284,23
"N00000247",309,302,0,7,0,24,10,10,0,0,0,0,7,0,0,7,0,24,299,292,7
"N00000248",337,318,1,17,1,20,1,1,0,0,0,0,19,0,1,17,1,20,336,317,19
"N00000249",386,370,0,15,0,17,4,3,1,0,1,0,16,0,0,16,0,17,382,367,15
"N00000250",401,384,1,14,1,17,3,2,1,0,1,0,17,0,1,15,1,17,398,382,16
"N00000251",456,433,0,23,0,34,0,0,0,0,0,0,23,0,0,23,0,34,456,433,23
"N00000252",345,323,3,18,1,23,5,5,0,0,0,0,22,1,3,18,1,24,340,318,22
"N00000253",499,469,0,29,1,23,0,0,0,0,0,0,30,0,0,29,1,23,499,469,30
"N00000254",315,307,0,7,1,30,2,2,0,0,0,0,8,0,0,7,1,30,313,305,8
"N00000255",351,330,1,19,1,11,4,4,0,0,0,0,21,0,1,19,1,11,347,326,21
"N00000256",780,703,5,55,16,33,5,4,1,0,1,0,77,2,5,56,16,35,775,699,76
"N00000257",447,414,0,31,2,42,1,1,0,0,0,0,33,1,0,31,2,43,446,413,33
"N00000258",379,368,0,10,1,21,5,5,0,0,0,0,11,1,0,10,1,22,374,363,11
"N00000259",465,445,0,17,3,24,4,4,0,0,0,0,20,0,0,17,3,24,461,441,20
"N00000260",560,510,1,48,1,21,3,3,0,0,0,0,50,0,1,48,1,21,557,507,50
"N00000261",561,541,2,18,0,30,5,5,0,0,0,0,20,0,2,18,0,30,556,536,20
"N00000262",419,390,4,24,0,8,3,2,1,0,1,0,29,0,4,25,0,8,416,388,28
"N00000263",239,215,1,23,0,15,1,1,0,0,0,0,24,1,1,23,0,16,238,214,24
"N00000264",566,534,0,31,1,39,1,1,0,0,0,0,32,0,0,31,1,39,565,533,32
"N00000265",351,319,2,26,4,25,0,0,0,0,0,0,32,0,2,26,4,25,351,319,32
"N00000266",328,318,0,10,0,17,8,8,0,0,0,0,10,0,0,10,0,17,320,310,10
"N00000267",431,423,0,6,2,26,0,0,0,0,0,0,8,0,0,6,2,26,431,423,8
"N00000268",384,361,1,20,2,12,0,0,0,0,0,0,23,0,1,20,2,12,384,361,23
"N00000269",347,345,0,2,0,13,1,1,0,0,0,0,2,0,0,2,0,13,346,344,2
"N00000270",371,357,3,11,0,39,1,1,0,0,0,0,14,0,3,11,0,39,370,356,14
"N00000271",380,363,0,16,1,17,0,0,0,0,0,0,17,0,0,16,1,17,380,363,17
"N00000272",295,287,0,5,2,25,3,2,1,0,1,0,8,0,0,6,2,25,292,285,7
"N00000273",460,427,0,33,0,39,3,3,0,0,0,0,33,0,0,33,0,39,457,424,33
"N00000274",468,439,0,26,2,27,2,1,1,0,1,0,29,0,0,27,2,27,466,438,28
"N00000275",291,272,0,16,2,12,1,0,1,0,0,1,19,0,0,16,3,12,290,272,18
"N00000276",315,302,0,12,1,22,1,1,0,0,0,0,13,0,0,12,1,22,314,301,13
"N00000277",310,295,0,15,0,6,1,1,0,0,0,0,15,0,0,15,0,6,309,294,15
"N00000278",304,291,0,13,0,24,1,1,0,0,0,0,13,0,0,13,0,24,303,290,13
"N00000279",181,163,0,17,1,16,1,1,0,0,0,0,18,0,0,17,1,16,180,162,18
"N00000280",392,372,0,18,2,30,0,0,0,0,0,0,20,0,0,18,2,30,392,372,20
"N00000281",349,324,0,25,0,17,2,2,0,0,0,0,25,0,0,25,0,17,347,322,25
"N00000282",364,349,1,13,1,24,1,1,0,0,0,0,15,0,1,13,1,24,363,348,15
"N00000283",346,335,0,11,0,11,1,1,0,0,0,0,11,0,0,11,0,11,345,334,11
"N00000284",382,345,0,32,2,38,13,10,3,0,3,0,37,0,0,35,2,38,369,335,34
"N00000285",322,304,0,17,1,17,0,0,0,0,0,0,18,0,0,17,1,17,322,304,18
"N00000286",271,244,5,22,0,25,0,0,0,0,0,0,27,0,5,22,0,25,271,244,27
"N00000287",297,268,3,26,0,39,2,2,0,0,0,0,29,0,3,26,0,39,295,266,29
"N00000288",353,325,2,26,0,31,5,5,0,0,0,0,28,0,2,26,0,31,348,320,28
"N00000289",496,448,1,47,0,31,3,3,0,0,0,0,48,0,1,47,0,31,493,445,48
"N00000290",271,243,0,26,2,23,1,1,0,0,0,0,28,1,0,26,2,24,270,242,28
"N00000291",512,488,0,23,1,49,1,1,0,0,0,0,24,0,0,23,1,49,511,487,24
"N00000292",731,686,0,40,5,49,1,1,0,0,0,0,45,0,0,40,5,49,730,685,45
"N00000293",522,492,0,27,3,14,2,2,0,0,0,0,30,0,0,27,3,14,520,490,30
"N00000294",405,394,1,8,1,21,5,4,1,0,1,0,11,0,1,9,1,21,400,390,10
"N00000295",421,383,0,37,1,39,0,0,0,0,0,0,38,0,0,37,1,39,421,383,38
"N00000296",287,270,0,17,0,17,0,0,0,0,0,0,17,0,0,17,0,17,287,270,17
"N00000297",371,345,0,25,0,9,2,1,1,0,1,0,26,0,0,26,0,9,369,344,25
"N00000298",335,314,0,16,2,33,14,11,3,0,0,3,21,0,0,16,5,33,321,303,18
"N00000299",324,298,0,24,1,20,11,10,1,0,1,0,26,0,0,25,1,20,313,288,25
"N00000300",296,264,4,26,2,26,7,7,0,0,0,0,32,0,4,26,2,26,289,257,32
"N00000301",366,351,0,10,5,13,8,8,0,0,0,0,15,0,0,10,5,13,358,343,15
"N00000302",363,351,0,10,0,31,9,7,2,0,2,0,12,1,0,12,0,32,354,344,10
"N00000303",318,312,0,6,0,15,3,3,0,0,0,0,6,0,0,6,0,15,315,309,6
"N00000304",342,302,0,39,1,53,10,10,0,0,0,0,40,0,0,39,1,53,332,292,40
"N00000305",395,375,0,19,1,27,0,0,0,0,0,0,20,0,0,19,1,27,395,375,20
"N00000306",381,364,0,16,0,25,2,1,1,0,1,0,17,0,0,17,0,25,379,363,16
"N00000307",355,350,0,5,0,14,4,4,0,0,0,0,5,0,0,5,0,14,351,346,5
"N00000308",277,268,0,9,0,13,1,1,0,0,0,0,9,4,0,9,0,17,276,267,9
"N00000309",378,350,0,24,4,29,14,14,0,0,0,0,28,0,0,24,4,29,364,336,28
"N00000310",408,389,0,18,1,24,4,4,0,0,0,0,19,0,0,18,1,24,404,385,19
"N00000311",333,306,3,19,3,20,3,1,2,0,1,1,27,1,3,20,4,21,330,305,25
"N00000312",512,483,3,24,2,38,3,3,0,0,0,0,29,0,3,24,2,38,509,480,29
"N00000313",636,604,2,29,1,35,2,2,0,0,0,0,32,0,2,29,1,35,634,602,32
"N00000314",358,340,1,16,1,19,1,1,0,0,0,0,18,0,1,16,1,19,357,339,18
"N00000315",345,311,11,22,1,29,2,2,0,0,0,0,34,0,11,22,1,29,343,309,34
"N00000316",374,371,0,1,2,10,0,0,0,0,0,0,3,0,0,1,2,10,374,371,3
"N00000317",447,404,3,38,2,39,3,3,0,0,0,0,43,4,3,38,2,43,444,401,43
"N00000318",344,328,0,16,0,36,7,7,0,0,0,0,16,0,0,16,0,36,337,321,16
"N00000319",819,741,16,62,0,20,0,0,0,0,0,0,78,0,16,62,0,20,819,741,78
"N00000320",318,305,0,12,1,17,0,0,0,0,0,0,13,0,0,12,1,17,318,305,13
"N00000321",517,489,3,25,0,43,1,1,0,0,0,0,28,0,3,25,0,43,516,488,28
"N00000322",389,369,6,10,4,20,4,4,0,0,0,0,20,0,6,10,4,20,385,365,20
"N00000323",472,444,5,22,1,25,0,0,0,0,0,0,28,0,5,22,1,25,472,444,28
"N00000324",376,354,0,20,2,14,1,1,0,0,0,0,22,0,0,20,2,14,375,353,22
"N00000325",538,499,1,35,3,31,1,1,0,0,0,0,39,0,1,35,3,31,537,498,39
"N00000326",946,871,7,67,1,54,2,2,0,0,0,0,75,1,7,67,1,55,944,869,75
"N00000327",325,308,0,15,2,37,3,3,0,0,0,0,17,1,0,15,2,38,322,305,17
"N00000328",291,280,0,11,0,21,7,7,0,0,0,0,11,0,0,11,0,21,284,273,11
"N00000329",402,376,0,25,0,24,1,0,1,0,1,0,26,0,0,26,0,24,401,376,25
"N00000330",539,501,4,34,0,29,5,5,0,0,0,0,38,0,4,34,0,29,534,496,38
"N00000331",612,589,4,17,2,30,2,2,0,0,0,0,23,0,4,17,2,30,610,587,23
"N00000332",284,248,0,33,3,31,1,1,0,0,0,0,36,0,0,33,3,31,283,247,36
"N00000333",293,257,2,34,0,41,0,0,0,0,0,0,36,0,2,34,0,41,293,257,36
"N00000334",294,275,0,19,0,24,1,1,0,0,0,0,19,2,0,19,0,26,293,274,19
"N00000335",326,309,0,15,2,23,15,15,0,0,0,0,17,0,0,15,2,23,311,294,17
"N00000336",330,318,0,11,1,22,5,5,0,0,0,0,12,0,0,11,1,22,325,313,12
"N00000337",282,280,0,1,0,32,10,9,1,0,1,0,2,1,0,2,0,33,272,271,1
"N00000338",308,292,0,15,0,29,2,1,1,0,1,0,16,0,0,16,0,29,306,291,15
"N00000339",294,277,3,13,1,23,3,3,0,0,0,0,17,0,3,13,1,23,291,274,17
"N00000340",427,387,1,35,3,20,6,5,1,0,1,0,40,1,1,36,3,21,421,382,39
"N00000341",348,338,0,9,0,26,2,1,1,0,0,1,10,0,0,9,1,26,346,337,9
"N00000342",359,335,2,21,1,33,0,0,0,0,0,0,24,0,2,21,1,33,359,335,24
"N00000343",351,335,0,16,0,18,2,2,0,0,0,0,16,0,0,16,0,18,349,333,16
"N00000344",406,372,3,30,0,20,15,14,1,0,1,0,34,0,3,31,0,20,391,358,33
"N00000345",416,394,7,15,0,13,1,1,0,0,0,0,22,0,7,15,0,13,415,393,22
"N00000346",685,636,4,39,6,40,4,4,0,0,0,0,49,2,4,39,6,42,681,632,49
"N00000347",257,232,0,18,6,12,6,5,1,0,1,0,25,0,0,19,6,12,251,227,24
"N00000348",426,398,0,22,6,43,0,0,0,0,0,0,28,0,0,22,6,43,426,398,28
"N00000349",368,348,1,11,5,24,10,7,3,0,2,1,20,0,1,13,6,24,358,341,17
"N00000350",577,549,0,26,2,25,5,5,0,0,0,0,28,7,0,26,2,32,572,544,28
"N00000351",414,384,10,18,2,17,1,1,0,0,0,0,30,0,10,18,2,17,413,383,30
"N00000352",466,447,0,19,0,32,1,1,0,0,0,0,19,0,0,19,0,32,465,446,19
"N00000353",422,404,4,13,1,23,3,3,0,0,0,0,18,0,4,13,1,23,419,401,18
"N00000354",405,386,2,17,0,17,6,6,0,0,0,0,19,0,2,17,0,17,399,380,19
"N00000355",441,422,0,16,2,19,4,3,1,0,0,1,19,0,0,16,3,19,437,419,18
"N00000356",414,392,1,19,2,24,18,18,0,0,0,0,22,0,1,19,2,24,396,374,22
"N00000357",1212,1075,16,88,22,88,53,42,11,0,5,6,137,2,16,93,28,90,1159,1033,126
"N00000358",371,337,0,26,8,19,13,13,0,0,0,0,34,4,0,26,8,23,358,324,34
"N00000359",820,708,3,84,23,92,35,33,2,0,2,0,112,6,3,86,23,98,785,675,110
"N00000360",423,395,6,16,6,17,0,0,0,0,0,0,28,0,6,16,6,17,423,395,28
"N00000361",413,357,0,48,4,26,5,1,4,0,1,3,56,2,0,49,7,28,408,356,52
"N00000362",390,358,1,31,0,9,3,3,0,0,0,0,32,0,1,31,0,9,387,355,32
"N00000363",484,478,0,6,0,19,0,0,0,0,0,0,6,0,0,6,0,19,484,478,6
"N00000364",475,464,0,10,1,20,0,0,0,0,0,0,11,0,0,10,1,20,475,464,11
"N00000365",255,238,2,11,3,6,1,0,1,0,1,0,17,0,2,12,3,6,254,238,16
"N00000366",536,496,2,26,8,20,14,10,4,3,1,0,40,7,5,27,8,27,522,486,36
"N00000367",351,329,2,15,5,15,3,3,0,0,0,0,22,0,2,15,5,15,348,326,22
"N00000368",544,509,0,34,1,37,1,1,0,0,0,0,35,0,0,34,1,37,543,508,35
"N00000369",411,400,1,9,1,16,5,5,0,0,0,0,11,0,1,9,1,16,406,395,11
"N00000370",485,457,0,26,2,26,0,0,0,0,0,0,28,0,0,26,2,26,485,457,28
"N00000371",447,426,3,17,1,36,1,1,0,0,0,0,21,0,3,17,1,36,446,425,21
"N00000372",380,351,0,24,5,32,8,8,0,0,0,0,29,0,0,24,5,32,372,343,29
"N00000373",437,391,0,33,6,44,12,5,7,0,6,1,46,1,0,39,7,45,425,386,39
"N00000374",348,297,1,41,9,19,5,5,0,0,0,0,51,0,1,41,9,19,343,292,51
"N00000375",303,262,2,33,6,27,3,3,0,0,0,0,41,0,2,33,6,27,300,259,41
"N00000376",261,251,0,6,4,22,0,0,0,0,0,0,10,0,0,6,4,22,261,251,10
"N00000377",268,253,0,13,2,19,1,1,0,0,0,0,15,0,0,13,2,19,267,252,15
"N00000378",289,273,0,16,0,50,4,4,0,0,0,0,16,4,0,16,0,54,285,269,16
"N00000379",490,459,0,26,1,51,7,3,4,0,4,0,31,0,0,30,1,51,483,456,27
"N00000380",532,512,2,11,6,40,1,0,1,0,1,0,20,0,2,12,6,40,531,512,19
"N00000381",979,912,2,45,20,40,1,1,0,0,0,0,67,0,2,45,20,40,978,911,67
"N00000382",557,526,0,26,5,41,0,0,0,0,0,0,31,1,0,26,5,42,557,526,31
"N00000383",472,465,2,3,2,32,0,0,0,0,0,0,7,1,2,3,2,33,472,465,7
"N00000384",490,461,2,12,14,11,2,1,1,0,0,1,29,0,2,12,15,11,488,460,28
"N00000385",445,425,0,18,1,18,2,1,1,0,0,1,20,1,0,18,2,19,443,424,19
"N00000386",291,266,1,19,2,23,3,0,3,0,3,0,25,0,1,22,2,23,288,266,22
"N00000387",227,214,0,7,1,17,8,3,5,0,5,0,13,0,0,12,1,17,219,211,8
"N00000388",1602,1444,14,120,15,135,13,4,9,0,8,1,158,2,14,128,16,137,1589,1440,149
"N00000389",445,426,0,19,0,31,4,4,0,0,0,0,19,16,0,19,0,47,441,422,19
"N00000390",972,920,1,48,3,46,4,4,0,0,0,0,52,0,1,48,3,46,968,916,52
"N00000391",524,511,0,10,3,36,1,1,0,0,0,0,13,0,0,10,3,36,523,510,13
"N00000392",1399,1286,14,86,13,94,10,10,0,0,0,0,113,4,14,86,13,98,1389,1276,113
"N00000393",459,425,3,31,0,43,2,2,0,0,0,0,34,0,3,31,0,43,457,423,34
"N00000394",406,374,0,32,0,26,4,4,0,0,0,0,32,1,0,32,0,27,402,370,32
"N00000395",508,465,2,37,4,58,1,1,0,0,0,0,43,0,2,37,4,58,507,464,43
"N00000396",376,367,0,9,0,11,6,6,0,0,0,0,9,0,0,9,0,11,370,361,9
"N00000397",520,505,3,8,2,21,7,5,2,0,2,0,15,0,3,10,2,21,513,500,13
"N00000398",463,441,2,19,1,39,5,5,0,0,0,0,22,0,2,19,1,39,458,436,22
"N00000399",304,285,0,19,0,15,1,1,0,0,0,0,19,0,0,19,0,15,303,284,19
"N00000400",240,212,0,28,0,23,2,2,0,0,0,0,28,0,0,28,0,23,238,210,28
"N00000401",286,262,4,13,7,18,0,0,0,0,0,0,24,0,4,13,7,18,286,262,24
"N00000402",248,224,2,17,5,31,0,0,0,0,0,0,24,0,2,17,5,31,248,224,24
"N00000403",522,481,0,23,15,39,5,2,3,0,3,0,41,0,0,26,15,39,517,479,38
"N00000404",276,249,6,20,1,22,0,0,0,0,0,0,27,0,6,20,1,22,276,249,27
"N00000405",223,208,2,9,4,9,0,0,0,0,0,0,15,3,2,9,4,12,223,208,15
"N00000406",397,381,0,12,4,20,0,0,0,0,0,0,16,0,0,12,4,20,397,381,16
"N00000407",1125,1086,0,33,2,60,17,13,4,0,4,0,39,0,0,37,2,60,1108,1073,35
"N00000408",468,448,1,18,1,15,4,4,0,0,0,0,20,0,1,18,1,15,464,444,20
"N00000409",403,364,1,38,0,29,0,0,0,0,0,0,39,0,1,38,0,29,403,364,39
"N00000410",392,374,0,16,2,8,0,0,0,0,0,0,18,0,0,16,2,8,392,374,18
"N00000411",355,339,1,10,5,20,2,2,0,0,0,0,16,1,1,10,5,21,353,337,16
"N00000412",438,408,0,25,5,20,0,0,0,0,0,0,30,0,0,25,5,20,438,408,30
"N00000413",442,424,0,11,7,34,3,3,0,0,0,0,18,0,0,11,7,34,439,421,18
"N00000414",380,366,6,7,1,18,0,0,0,0,0,0,14,0,6,7,1,18,380,366,14
"N00000415",439,420,5,11,3,37,1,1,0,0,0,0,19,0,5,11,3,37,438,419,19
"N00000416",420,407,2,9,2,32,1,1,0,0,0,0,13,0,2,9,2,32,419,406,13
"N00000417",533,495,2,36,0,41,3,3,0,0,0,0,38,0,2,36,0,41,530,492,38
"N00000418",857,804,0,49,3,57,3,2,1,0,0,1,53,1,0,49,4,58,854,802,52
"N00000419",354,331,0,19,3,18,1,0,1,0,1,0,23,0,0,20,3,18,353,331,22
"N00000420",339,334,1,4,0,6,4,4,0,0,0,0,5,0,1,4,0,6,335,330,5
"N00000421",530,516,0,12,2,50,1,1,0,0,0,0,14,0,0,12,2,50,529,515,14
"N00000422",422,405,0,16,1,30,0,0,0,0,0,0,17,0,0,16,1,30,422,405,17
"N00000423",461,446,0,14,1,11,2,2,0,0,0,0,15,0,0,14,1,11,459,444,15
"N00000424",561,522,1,29,9,20,4,4,0,0,0,0,39,0,1,29,9,20,557,518,39
"N00000425",363,361,0,0,2,29,0,0,0,0,0,0,2,0,0,0,2,29,363,361,2
"N00000426",307,283,0,22,1,35,6,5,1,0,1,0,24,1,0,23,1,36,301,278,23
"N00000427",339,301,14,24,0,12,1,1,0,0,0,0,38,0,14,24,0,12,338,300,38
"N00000428",398,385,1,12,0,24,0,0,0,0,0,0,13,0,1,12,0,24,398,385,13
"N00000429",474,458,0,15,0,24,1,0,1,0,1,0,16,0,0,16,0,24,473,458,15
"N00000430",497,463,0,32,2,20,0,0,0,0,0,0,34,0,0,32,2,20,497,463,34
"N00000431",361,341,3,15,1,17,1,0,1,0,0,1,20,0,3,15,2,17,360,341,19
"N00000432",285,273,0,12,0,10,0,0,0,0,0,0,12,0,0,12,0,10,285,273,12
"N00000433",280,242,6,30,0,44,3,1,2,0,2,0,38,0,6,32,0,44,277,241,36
"N00000434",445,408,3,31,3,21,1,1,0,0,0,0,37,0,3,31,3,21,444,407,37
"N00000435",430,382,9,29,7,32,4,1,3,0,0,3,48,0,9,29,10,32,426,381,45
"N00000436",522,493,1,23,5,33,0,0,0,0,0,0,29,0,1,23,5,33,522,493,29
"N00000437",664,640,2,19,3,35,4,4,0,0,0,0,24,0,2,19,3,35,660,636,24
"N00000438",475,460,0,13,1,19,1,0,1,0,0,1,15,1,0,13,2,20,474,460,14
"N00000439",419,403,0,16,0,17,0,0,0,0,0,0,16,0,0,16,0,17,419,403,16
"N00000440",417,396,1,18,2,19,1,1,0,0,0,0,21,0,1,18,2,19,416,395,21
"N00000441",311,296,0,12,1,40,2,0,2,0,2,0,15,0,0,14,1,40,309,296,13
"N00000442",444,395,3,42,4,29,4,4,0,0,0,0,49,2,3,42,4,31,440,391,49
"N00000443",488,441,0,43,3,31,6,5,1,0,0,1,47,3,0,43,4,34,482,436,46
"N00000444",566,501,3,55,4,52,15,12,3,0,2,1,65,5,3,57,5,57,551,489,62
"N00000445",397,365,0,29,3,15,4,4,0,0,0,0,32,0,0,29,3,15,393,361,32
"N00000446",336,301,1,33,1,41,7,7,0,0,0,0,35,1,1,33,1,42,329,294,35
"N00000447",309,276,6,23,3,20,2,1,1,0,1,0,33,0,6,24,3,20,307,275,32
"N00000448",246,214,7,22,2,48,8,7,1,0,1,0,32,1,7,23,2,49,238,207,31
"N00000449",435,413,3,18,0,23,1,0,1,0,1,0,22,0,3,19,0,23,434,413,21
"N00000450",491,452,0,38,1,32,0,0,0,0,0,0,39,1,0,38,1,33,491,452,39
"N00000451",493,454,0,36,3,32,2,2,0,0,0,0,39,0,0,36,3,32,491,452,39
"N00000452",452,422,0,24,6,20,6,6,0,0,0,0,30,0,0,24,6,20,446,416,30
"N00000453",335,319,0,16,0,32,0,0,0,0,0,0,16,0,0,16,0,32,335,319,16
"N00000454",514,483,0,28,3,15,3,3,0,0,0,0,31,0,0,28,3,15,511,480,31
"N00000455",273,256,0,16,1,17,1,1,0,0,0,0,17,0,0,16,1,17,272,255,17
"N00000456",322,305,0,17,0,38,0,0,0,0,0,0,17,0,0,17,0,38,322,305,17
"N00000457",347,328,1,16,2,30,1,1,0,0,0,0,19,0,1,16,2,30,346,327,19
"N00000458",366,337,0,28,1,14,2,2,0,0,0,0,29,0,0,28,1,14,364,335,29
"N00000459",690,613,5,71,1,32,1,1,0,0,0,0,77,0,5,71,1,32,689,612,77
"N00000460",359,315,1,34,7,24,4,2,2,0,2,0,44,0,1,36,7,24,355,313,42
"N00000461",421,401,0,20,0,13,0,0,0,0,0,0,20,0,0,20,0,13,421,401,20
"N00000462",232,214,0,16,1,17,1,0,1,0,1,0,18,0,0,17,1,17,231,214,17
"N00000463",777,695,4,66,12,64,8,8,0,0,0,0,82,2,4,66,12,66,769,687,82
"N00000464",436,416,5,15,0,18,1,1,0,0,0,0,20,0,5,15,0,18,435,415,20
"N00000465",305,284,3,18,0,16,1,1,0,0,0,0,21,0,3,18,0,16,304,283,21
"N00000466",375,355,0,18,2,19,3,3,0,0,0,0,20,0,0,18,2,19,372,352,20
"N00000467",290,262,0,27,0,18,2,1,1,0,1,0,28,0,0,28,0,18,288,261,27
"N00000468",302,281,0,16,5,9,0,0,0,0,0,0,21,0,0,16,5,9,302,281,21
"N00000469",440,416,0,24,0,22,0,0,0,0,0,0,24,0,0,24,0,22,440,416,24
"N00000470",286,264,2,18,2,46,4,4,0,0,0,0,22,0,2,18,2,46,282,260,22
"N00000471",286,264,0,17,4,33,14,13,1,0,1,0,22,0,0,18,4,33,272,251,21
"N00000472",222,188,0,23,6,28,6,1,5,0,4,1,34,3,0,27,7,31,216,187,29
"N00000473",202,184,0,16,2,12,0,0,0,0,0,0,18,0,0,16,2,12,202,184,18
"N00000474",250,222,0,20,5,28,11,8,3,0,3,0,28,1,0,23,5,29,239,214,25
"N00000475",238,202,1,31,0,15,7,3,4,2,1,1,36,0,3,32,1,15,231,199,32
"N00000476",256,227,4,21,4,17,0,0,0,0,0,0,29,11,4,21,4,28,256,227,29
"N00000477",721,702,0,16,0,30,12,9,3,0,3,0,19,0,0,19,0,30,709,693,16
"N00000478",294,270,0,22,1,63,15,14,1,0,1,0,24,10,0,23,1,73,279,256,23
"N00000479",280,269,0,10,0,14,9,8,1,0,1,0,11,0,0,11,0,14,271,261,10
"N00000480",335,314,0,18,2,19,4,3,1,0,1,0,21,0,0,19,2,19,331,311,20
"N00000481",469,411,0,54,2,57,5,3,2,0,2,0,58,0,0,56,2,57,464,408,56
"N00000482",225,209,0,16,0,20,2,2,0,0,0,0,16,0,0,16,0,20,223,207,16
"N00000483",285,275,0,10,0,20,8,8,0,0,0,0,10,0,0,10,0,20,277,267,10
"N00000484",330,307,0,23,0,13,12,12,0,0,0,0,23,0,0,23,0,13,318,295,23
"N00000485",241,226,0,15,0,24,5,5,0,0,0,0,15,0,0,15,0,24,236,221,15
"N00000486",372,351,3,17,0,15,5,4,1,0,1,0,21,0,3,18,0,15,367,347,20
"N00000487",290,275,6,9,0,14,0,0,0,0,0,0,15,0,6,9,0,14,290,275,15
"N00000488",409,393,0,16,0,16,4,4,0,0,0,0,16,0,0,16,0,16,405,389,16
"N00000489",282,264,0,18,0,24,0,0,0,0,0,0,18,0,0,18,0,24,282,264,18
"N00000490",515,482,0,32,1,54,1,1,0,0,0,0,33,0,0,32,1,54,514,481,33
"N00000491",525,484,0,36,5,8,0,0,0,0,0,0,41,0,0,36,5,8,525,484,41
"N00000492",414,372,3,36,2,42,4,3,1,0,0,1,42,0,3,36,3,42,410,369,41
"N00000493",331,315,3,13,0,27,4,4,0,0,0,0,16,0,3,13,0,27,327,311,16
"N00000494",825,734,4,72,14,41,10,9,1,0,0,1,91,0,4,72,15,41,815,725,90
"N00000495",336,321,0,11,4,26,2,2,0,0,0,0,15,0,0,11,4,26,334,319,15
"N00000496",837,771,0,59,5,51,17,15,2,0,2,0,66,0,0,61,5,51,820,756,64
"N00000497",837,749,3,75,10,45,16,16,0,0,0,0,88,0,3,75,10,45,821,733,88
"N00000498",337,295,2,30,10,26,5,5,0,0,0,0,42,9,2,30,10,35,332,290,42
"N00000499",296,281,0,15,0,46,2,2,0,0,0,0,15,2,0,15,0,48,294,279,15
"N00000500",503,462,0,38,3,38,0,0,0,0,0,0,41,1,0,38,3,39,503,462,41
"N00000501",300,265,0,34,0,37,2,1,1,0,1,0,35,0,0,35,0,37,298,264,34
"N00000502",196,169,0,27,0,25,0,0,0,0,0,0,27,0,0,27,0,25,196,169,27
"N00000503",395,355,2,38,0,34,3,3,0,0,0,0,40,0,2,38,0,34,392,352,40
"N00000504",236,198,0,38,0,33,1,1,0,0,0,0,38,0,0,38,0,33,235,197,38
"N00000505",225,208,0,17,0,19,1,1,0,0,0,0,17,0,0,17,0,19,224,207,17
"N00000506",282,264,0,17,0,25,3,2,1,0,1,0,18,1,0,18,0,26,279,262,17
"N00000507",269,258,0,11,0,15,5,5,0,0,0,0,11,0,0,11,0,15,264,253,11
"N00000508",316,312,0,2,0,10,9,7,2,0,2,0,4,0,0,4,0,10,307,305,2
"N00000509",357,332,1,18,0,32,8,2,6,0,6,0,25,1,1,24,0,33,349,330,19
"N00000510",290,268,0,22,0,22,3,3,0,0,0,0,22,0,0,22,0,22,287,265,22
"N00000511",520,451,0,67,2,26,0,0,0,0,0,0,69,1,0,67,2,27,520,451,69
"N00000512",430,401,1,26,2,31,7,7,0,0,0,0,29,1,1,26,2,32,423,394,29
"N00000513",327,305,0,17,5,17,4,4,0,0,0,0,22,0,0,17,5,17,323,301,22
"N00000514",357,331,0,21,5,23,3,3,0,0,0,0,26,0,0,21,5,23,354,328,26
"N00000515",345,322,0,23,0,6,0,0,0,0,0,0,23,0,0,23,0,6,345,322,23
"N00000516",215,206,0,9,0,16,3,3,0,0,0,0,9,0,0,9,0,16,212,203,9
"N00000517",394,352,0,40,1,16,6,5,1,0,1,0,42,0,0,41,1,16,388,347,41
"N00000518",311,282,0,26,0,30,4,1,3,0,3,0,29,0,0,29,0,30,307,281,26
"N00000519",260,236,3,21,0,7,0,0,0,0,0,0,24,0,3,21,0,7,260,236,24
"N00000520",612,547,10,54,0,42,7,6,1,0,1,0,65,0,10,55,0,42,605,541,64
"N00000521",413,383,1,26,3,32,3,3,0,0,0,0,30,8,1,26,3,40,410,380,30
"N00000522",451,409,2,39,1,43,1,1,0,0,0,0,42,0,2,39,1,43,450,408,42
"N00000523",397,364,0,32,1,20,1,1,0,0,0,0,33,1,0,32,1,21,396,363,33
"N00000524",488,462,0,19,7,34,1,1,0,0,0,0,26,0,0,19,7,34,487,461,26
"N00000525",431,375,0,54,2,28,1,1,0,0,0,0,56,0,0,54,2,28,430,374,56
"N00000526",260,222,1,24,13,48,8,8,0,0,0,0,38,4,1,24,13,52,252,214,38
"N00000527",344,297,0,34,12,49,4,3,1,0,1,0,47,0,0,35,12,49,340,294,46
"N00000528",247,202,1,36,8,37,9,9,0,0,0,0,45,0,1,36,8,37,238,193,45
"N00000529",238,211,3,15,7,37,11,9,2,0,2,0,27,0,3,17,7,37,227,202,25
"N00000530",292,260,6,19,7,24,0,0,0,0,0,0,32,0,6,19,7,24,292,260,32
"N00000531",317,265,4,37,10,22,9,8,1,0,1,0,52,0,4,38,10,22,308,257,51
"N00000532",214,193,0,14,7,24,11,11,0,0,0,0,21,4,0,14,7,28,203,182,21
"N00000533",214,189,0,22,3,12,6,6,0,0,0,0,25,0,0,22,3,12,208,183,25
"N00000534",490,467,0,15,7,32,1,0,1,0,1,0,23,0,0,16,7,32,489,467,22
"N00000535",519,497,1,19,2,15,2,2,0,0,0,0,22,0,1,19,2,15,517,495,22
"N00000536",392,371,0,20,1,18,0,0,0,0,0,0,21,0,0,20,1,18,392,371,21
"N00000537",413,396,0,15,1,13,3,2,1,0,0,1,17,0,0,15,2,13,410,394,16
"N00000538",395,380,4,11,0,42,1,1,0,0,0,0,15,0,4,11,0,42,394,379,15
"N00000539",381,359,0,22,0,33,0,0,0,0,0,0,22,0,0,22,0,33,381,359,22
"N00000540",291,284,0,7,0,12,1,1,0,0,0,0,7,0,0,7,0,12,290,283,7
"N00000541",407,386,0,21,0,14,0,0,0,0,0,0,21,1,0,21,0,15,407,386,21
"N00000542",265,255,0,10,0,9,0,0,0,0,0,0,10,0,0,10,0,9,265,255,10
"N00000543",389,360,1,23,5,32,0,0,0,0,0,0,29,0,1,23,5,32,389,360,29
"N00000544",273,247,0,24,2,29,0,0,0,0,0,0,26,5,0,24,2,34,273,247,26
"N00000545",288,263,0,25,0,10,4,4,0,0,0,0,25,1,0,25,0,11,284,259,25
"N00000546",280,255,0,25,0,16,0,0,0,0,0,0,25,0,0,25,0,16,280,255,25
"N00000547",327,306,1,20,0,17,4,4,0,0,0,0,21,0,1,20,0,17,323,302,21
"N00000548",285,265,0,15,5,30,0,0,0,0,0,0,20,0,0,15,5,30,285,265,20
"N00000549",215,204,0,10,1,27,6,6,0,0,0,0,11,1,0,10,1,28,209,198,11
"N00000550",429,365,6,49,9,60,5,5,0,0,0,0,64,3,6,49,9,63,424,360,64
"N00000551",269,226,0,30,9,8,11,7,4,0,4,0,43,1,0,34,9,9,258,219,39
"N00000552",254,223,0,26,5,28,0,0,0,0,0,0,31,1,0,26,5,29,254,223,31
"N00000553",347,302,2,22,19,23,7,5,2,0,2,0,45,1,2,24,19,24,340,297,43
"N00000554",250,204,5,21,19,12,9,8,1,0,1,0,46,1,5,22,19,13,241,196,45
"N00000555",251,210,0,37,3,18,14,13,1,0,1,0,41,1,0,38,3,19,237,197,40
"N00000556",348,297,3,47,1,42,7,7,0,0,0,0,51,1,3,47,1,43,341,290,51
"N00000557",552,543,1,7,1,15,0,0,0,0,0,0,9,0,1,7,1,15,552,543,9
"N00000558",466,446,0,17,3,9,0,0,0,0,0,0,20,0,0,17,3,9,466,446,20
"N00000559",322,298,0,22,2,21,0,0,0,0,0,0,24,0,0,22,2,21,322,298,24
"N00000560",413,392,0,20,0,21,1,0,1,0,0,1,21,1,0,20,1,22,412,392,20
"N00000561",493,483,0,7,1,25,3,1,2,0,2,0,10,0,0,9,1,25,490,482,8
"N00000562",364,344,0,20,0,4,0,0,0,0,0,0,20,0,0,20,0,4,364,344,20
"N00000563",923,835,9,59,16,85,40,36,4,0,4,0,88,0,9,63,16,85,883,799,84
"N00000564",323,288,0,22,13,31,13,13,0,0,0,0,35,0,0,22,13,31,310,275,35
"N00000565",218,194,0,24,0,27,2,2,0,0,0,0,24,2,0,24,0,29,216,192,24
"N00000566",320,286,0,31,2,19,7,6,1,0,1,0,34,0,0,32,2,19,313,280,33
"N00000567",517,498,0,19,0,17,5,5,0,0,0,0,19,0,0,19,0,17,512,493,19
"N00000568",369,337,0,28,4,41,0,0,0,0,0,0,32,0,0,28,4,41,369,337,32
"N00000569",380,352,6,19,1,34,7,5,2,0,0,2,28,0,6,19,3,34,373,347,26
"N00000570",337,317,0,18,1,19,2,1,1,0,1,0,20,0,0,19,1,19,335,316,19
"N00000571",303,298,0,4,0,9,6,5,1,0,0,1,5,0,0,4,1,9,297,293,4
"N00000572",572,535,0,36,0,32,11,10,1,0,1,0,37,0,0,37,0,32,561,525,36
"N00000573",364,323,0,41,0,21,8,8,0,0,0,0,41,0,0,41,0,21,356,315,41
"N00000574",435,405,0,20,1,35,20,11,9,0,9,0,30,4,0,29,1,39,415,394,21
"N00000575",462,444,0,17,1,10,0,0,0,0,0,0,18,0,0,17,1,10,462,444,18
"N00000576",344,309,3,32,0,31,0,0,0,0,0,0,35,5,3,32,0,36,344,309,35
"N00000577",434,412,3,17,1,26,2,1,1,0,1,0,22,1,3,18,1,27,432,411,21
"N00000578",718,680,5,25,8,44,5,5,0,0,0,0,38,0,5,25,8,44,713,675,38
"N00000579",480,460,1,18,1,20,1,1,0,0,0,0,20,0,1,18,1,20,479,459,20
"N00000580",474,447,11,16,0,30,0,0,0,0,0,0,27,1,11,16,0,31,474,447,27
"N00000581",539,516,0,17,6,19,0,0,0,0,0,0,23,0,0,17,6,19,539,516,23
"N00000582",401,388,0,12,1,13,1,1,0,0,0,0,13,0,0,12,1,13,400,387,13
"N00000583",305,292,0,12,1,36,3,3,0,0,0,0,13,0,0,12,1,36,302,289,13
"N00000584",493,465,0,25,3,30,3,3,0,0,0,0,28,0,0,25,3,30,490,462,28
"N00000585",477,456,0,20,1,36,2,2,0,0,0,0,21,0,0,20,1,36,475,454,21
"N00000586",446,425,2,18,1,38,0,0,0,0,0,0,21,0,2,18,1,38,446,425,21
"N00000587",465,446,0,14,2,20,10,7,3,0,2,1,19,1,0,16,3,21,455,439,16
"N00000588",394,374,2,18,0,21,0,0,0,0,0,0,20,0,2,18,0,21,394,374,20
"N00000589",639,600,4,34,1,28,2,2,0,0,0,0,39,0,4,34,1,28,637,598,39
"N00000590",416,409,1,5,0,25,3,2,1,0,0,1,7,0,1,5,1,25,413,407,6
"N00000591",454,436,0,17,1,20,2,2,0,0,0,0,18,1,0,17,1,21,452,434,18
"N00000592",480,452,2,26,0,14,0,0,0,0,0,0,28,0,2,26,0,14,480,452,28
"N00000593",576,562,1,11,2,29,4,4,0,0,0,0,14,0,1,11,2,29,572,558,14
"N00000594",371,351,2,18,0,16,0,0,0,0,0,0,20,0,2,18,0,16,371,351,20
"N00000595",525,496,0,28,1,35,2,2,0,0,0,0,29,1,0,28,1,36,523,494,29
"N00000596",293,273,2,13,2,19,11,8,3,0,0,3,20,0,2,13,5,19,282,265,17
"N00000597",235,219,1,15,0,31,6,6,0,0,0,0,16,0,1,15,0,31,229,213,16
"N00000598",287,227,0,52,5,30,5,2,3,0,2,1,60,4,0,54,6,34,282,225,57
"N00000599",223,199,0,22,0,24,13,11,2,0,0,2,24,0,0,22,2,24,210,188,22
"N00000600",350,316,0,29,3,17,10,8,2,0,1,1,34,0,0,30,4,17,340,308,32
"N00000601",283,254,0,24,4,15,10,9,1,0,1,0,29,0,0,25,4,15,273,245,28
"N00000602",214,209,0,5,0,17,5,5,0,0,0,0,5,0,0,5,0,17,209,204,5
"N00000603",414,365,0,46,0,30,3,0,3,0,3,0,49,0,0,49,0,30,411,365,46
"N00000604",340,313,2,25,0,25,1,1,0,0,0,0,27,6,2,25,0,31,339,312,27
"N00000605",488,435,5,46,1,41,5,4,1,0,1,0,53,4,5,47,1,45,483,431,52
"N00000606",352,327,1,23,0,18,2,1,1,0,1,0,25,4,1,24,0,22,350,326,24
"N00000607",310,295,0,15,0,31,2,2,0,0,0,0,15,0,0,15,0,31,308,293,15
"N00000608",365,352,1,12,0,28,1,1,0,0,0,0,13,0,1,12,0,28,364,351,13
"N00000609",375,367,0,8,0,12,1,1,0,0,0,0,8,0,0,8,0,12,374,366,8
"N00000610",419,395,4,19,1,14,4,4,0,0,0,0,24,0,4,19,1,14,415,391,24
"N00000611",301,283,0,16,2,28,2,2,0,0,0,0,18,0,0,16,2,28,299,281,18
"N00000612",543,494,4,44,1,49,1,1,0,0,0,0,49,0,4,44,1,49,542,493,49
"N00000613",236,228,0,8,0,11,0,0,0,0,0,0,8,0,0,8,0,11,236,228,8
"N00000614",217,187,0,29,1,25,0,0,0,0,0,0,30,0,0,29,1,25,217,187,30
"N00000615",139,123,1,13,2,7,0,0,0,0,0,0,16,1,1,13,2,8,139,123,16
"N00000616",301,276,0,24,1,14,2,2,0,0,0,0,25,0,0,24,1,14,299,274,25
"N00000617",310,295,1,13,1,20,0,0,0,0,0,0,15,6,1,13,1,26,310,295,15
"N00000618",621,537,7,53,15,89,18,9,9,0,5,4,84,1,7,58,19,90,603,528,75
"N00000619",371,360,0,10,1,11,3,3,0,0,0,0,11,0,0,10,1,11,368,357,11
"N00000620",372,357,0,14,1,8,6,6,0,0,0,0,15,0,0,14,1,8,366,351,15
"N00000621",390,328,1,47,10,73,11,7,4,0,4,0,62,3,1,51,10,76,379,321,58
"N00000622",385,329,0,46,10,71,3,3,0,0,0,0,56,1,0,46,10,72,382,326,56
"N00000623",332,324,0,8,0,15,0,0,0,0,0,0,8,0,0,8,0,15,332,324,8
"N00000624",469,446,0,21,2,15,1,1,0,0,0,0,23,0,0,21,2,15,468,445,23
"N00000625",262,243,0,18,1,10,7,7,0,0,0,0,19,0,0,18,1,10,255,236,19
"N00000626",492,469,0,21,2,20,1,1,0,0,0,0,23,0,0,21,2,20,491,468,23
"N00000627",456,416,0,40,0,16,0,0,0,0,0,0,40,0,0,40,0,16,456,416,40
"N00000628",415,389,0,21,5,15,4,4,0,0,0,0,26,0,0,21,5,15,411,385,26
"N00000629",438,396,1,41,0,46,1,1,0,0,0,0,42,0,1,41,0,46,437,395,42
"N00000630",272,255,1,16,0,32,3,3,0,0,0,0,17,0,1,16,0,32,269,252,17
"N00000631",406,381,1,23,1,15,0,0,0,0,0,0,25,0,1,23,1,15,406,381,25
"N00000632",474,438,0,36,0,29,3,3,0,0,0,0,36,0,0,36,0,29,471,435,36
"N00000633",325,305,0,20,0,34,0,0,0,0,0,0,20,0,0,20,0,34,325,305,20
"N00000634",495,462,0,33,0,25,4,4,0,0,0,0,33,0,0,33,0,25,491,458,33
"N00000635",410,405,0,5,0,10,0,0,0,0,0,0,5,0,0,5,0,10,410,405,5
"N00000636",399,382,0,17,0,16,2,2,0,0,0,0,17,0,0,17,0,16,397,380,17
"N00000637",832,779,0,42,10,59,14,13,1,0,1,0,53,0,0,43,10,59,818,766,52
"N00000638",398,364,0,29,5,25,2,2,0,0,0,0,34,0,0,29,5,25,396,362,34
"N00000639",408,399,0,9,0,34,0,0,0,0,0,0,9,1,0,9,0,35,408,399,9
"N00000640",343,324,0,18,1,34,9,9,0,0,0,0,19,0,0,18,1,34,334,315,19
"N00000641",341,324,0,16,1,32,2,2,0,0,0,0,17,0,0,16,1,32,339,322,17
"N00000642",389,362,1,23,3,49,0,0,0,0,0,0,27,0,1,23,3,49,389,362,27
"N00000643",477,467,0,8,2,8,0,0,0,0,0,0,10,0,0,8,2,8,477,467,10
"N00000644",548,512,4,31,1,11,0,0,0,0,0,0,36,0,4,31,1,11,548,512,36
"N00000645",451,441,0,10,0,14,0,0,0,0,0,0,10,0,0,10,0,14,451,441,10
"N00000646",419,400,6,13,0,17,3,3,0,0,0,0,19,0,6,13,0,17,416,397,19
"N00000647",723,686,6,31,0,26,0,0,0,0,0,0,37,0,6,31,0,26,723,686,37
"N00000648",381,361,0,18,2,21,2,2,0,0,0,0,20,0,0,18,2,21,379,359,20
"N00000649",389,369,0,20,0,12,2,2,0,0,0,0,20,0,0,20,0,12,387,367,20
"N00000650",602,561,1,40,0,47,4,4,0,0,0,0,41,3,1,40,0,50,598,557,41
"N00000651",278,249,3,24,1,43,4,3,1,0,1,0,29,0,3,25,1,43,274,246,28
"N00000652",533,502,0,28,3,53,0,0,0,0,0,0,31,2,0,28,3,55,533,502,31
"N00000653",309,292,0,16,1,26,0,0,0,0,0,0,17,1,0,16,1,27,309,292,17
"N00000654",269,252,0,17,0,22,0,0,0,0,0,0,17,0,0,17,0,22,269,252,17
"N00000655",368,344,1,21,1,23,3,2,1,0,1,0,24,0,1,22,1,23,365,342,23
"N00000656",242,224,0,16,2,14,1,1,0,0,0,0,18,1,0,16,2,15,241,223,18
"N00000657",851,794,8,45,2,62,7,5,2,0,1,1,57,1,8,46,3,63,844,789,55
"N00000658",364,352,0,11,1,23,1,1,0,0,0,0,12,0,0,11,1,23,363,351,12
"N00000659",391,375,0,15,1,25,2,2,0,0,0,0,16,0,0,15,1,25,389,373,16
"N00000660",387,363,0,23,1,19,4,4,0,0,0,0,24,0,0,23,1,19,383,359,24
"N00000661",384,370,0,14,0,23,2,2,0,0,0,0,14,0,0,14,0,23,382,368,14
"N00000662",352,350,0,2,0,24,0,0,0,0,0,0,2,2,0,2,0,26,352,350,2
"N00000663",395,367,0,25,2,28,3,2,1,0,0,1,28,0,0,25,3,28,392,365,27
"N00000664",378,337,0,30,11,37,3,3,0,0,0,0,41,1,0,30,11,38,375,334,41
"N00000665",485,455,5,23,2,28,1,1,0,0,0,0,30,0,5,23,2,28,484,454,30
"N00000666",439,420,0,13,6,10,0,0,0,0,0,0,19,0,0,13,6,10,439,420,19
"N00000667",538,512,0,21,5,26,9,9,0,0,0,0,26,0,0,21,5,26,529,503,26
"N00000668",323,310,4,9,0,8,2,2,0,0,0,0,13,0,4,9,0,8,321,308,13
"N00000669",493,469,1,19,4,41,4,4,0,0,0,0,24,0,1,19,4,41,489,465,24
"N00000670",292,269,2,20,1,18,4,4,0,0,0,0,23,1,2,20,1,19,288,265,23
"N00000671",239,234,0,4,1,12,0,0,0,0,0,0,5,0,0,4,1,12,239,234,5
"N00000672",324,309,0,15,0,23,0,0,0,0,0,0,15,0,0,15,0,23,324,309,15
"N00000673",943,857,15,70,0,58,7,6,1,0,1,0,86,0,15,71,0,58,936,851,85
"N00000674",316,301,1,14,0,11,5,5,0,0,0,0,15,0,1,14,0,11,311,296,15
"N00000675",387,372,0,12,3,36,4,4,0,0,0,0,15,1,0,12,3,37,383,368,15
"N00000676",721,650,6,62,3,52,11,11,0,0,0,0,71,0,6,62,3,52,710,639,71
"N00000677",295,239,0,56,0,45,6,6,0,0,0,0,56,0,0,56,0,45,289,233,56
"N00000678",531,507,3,21,0,33,0,0,0,0,0,0,24,0,3,21,0,33,531,507,24
"N00000679",561,513,0,48,0,34,0,0,0,0,0,0,48,0,0,48,0,34,561,513,48
"N00000680",413,379,2,27,5,12,1,1,0,0,0,0,34,0,2,27,5,12,412,378,34
"N00000681",385,373,0,11,1,16,1,1,0,0,0,0,12,0,0,11,1,16,384,372,12
"N00000682",485,475,1,7,2,20,0,0,0,0,0,0,10,0,1,7,2,20,485,475,10
"N00000683",391,374,0,15,0,22,2,0,2,0,2,0,17,0,0,17,0,22,389,374,15
"N00000684",595,554,0,37,4,25,0,0,0,0,0,0,41,1,0,37,4,26,595,554,41
"N00000685",326,296,5,22,1,23,7,5,2,1,1,0,30,3,6,23,1,26,319,291,28
"N00000686",499,488,0,11,0,17,2,2,0,0,0,0,11,0,0,11,0,17,497,486,11
"N00000687",379,365,0,14,0,17,1,1,0,0,0,0,14,0,0,14,0,17,378,364,14
"N00000688",407,390,0,16,1,18,1,1,0,0,0,0,17,8,0,16,1,26,406,389,17
"N00000689",392,384,0,7,1,11,0,0,0,0,0,0,8,0,0,7,1,11,392,384,8
"N00000690",282,242,0,40,0,37,0,0,0,0,0,0,40,0,0,40,0,37,282,242,40
"N00000691",303,279,3,20,1,31,2,2,0,0,0,0,24,0,3,20,1,31,301,277,24
"N00000692",244,217,2,25,0,10,1,1,0,0,0,0,27,0,2,25,0,10,243,216,27
"N00000693",287,270,0,16,1,11,0,0,0,0,0,0,17,0,0,16,1,11,287,270,17
"N00000694",873,775,2,88,7,114,7,6,1,0,1,0,98,0,2,89,7,114,866,769,97
"N00000695",518,483,6,22,3,41,7,3,4,0,4,0,35,0,6,26,3,41,511,480,31
"N00000696",180,153,3,23,0,23,1,0,1,0,1,0,27,5,3,24,0,28,179,153,26
"N00000697",380,345,0,30,2,17,7,4,3,0,3,0,35,0,0,33,2,17,373,341,32
"N00000698",451,416,2,31,2,36,4,4,0,0,0,0,35,1,2,31,2,37,447,412,35
"N00000699",256,235,0,21,0,11,0,0,0,0,0,0,21,0,0,21,0,11,256,235,21
"N00000700",262,232,1,24,5,14,1,1,0,0,0,0,30,0,1,24,5,14,261,231,30
"N00000701",235,221,1,12,1,9,0,0,0,0,0,0,14,0,1,12,1,9,235,221,14
"N00000702",771,668,11,85,5,50,8,6,2,0,2,0,103,0,11,87,5,50,763,662,101
"N00000703",342,322,0,20,0,11,6,6,0,0,0,0,20,0,0,20,0,11,336,316,20
"N00000704",656,621,0,32,2,39,2,1,1,0,0,1,35,0,0,32,3,39,654,620,34
"N00000705",680,634,3,42,0,71,6,5,1,0,1,0,46,0,3,43,0,71,674,629,45
"N00000706",437,422,0,15,0,13,1,1,0,0,0,0,15,2,0,15,0,15,436,421,15
"N00000707",360,337,3,20,0,23,1,1,0,0,0,0,23,0,3,20,0,23,359,336,23
"N00000708",466,439,2,25,0,22,1,1,0,0,0,0,27,0,2,25,0,22,465,438,27
"N00000709",465,429,0,35,1,36,0,0,0,0,0,0,36,0,0,35,1,36,465,429,36
"N00000710",345,327,0,18,0,11,0,0,0,0,0,0,18,0,0,18,0,11,345,327,18
"N00000711",522,476,1,45,0,35,1,1,0,0,0,0,46,0,1,45,0,35,521,475,46
"N00000712",385,362,0,19,4,13,0,0,0,0,0,0,23,0,0,19,4,13,385,362,23
"N00000713",421,407,1,12,1,20,0,0,0,0,0,0,14,0,1,12,1,20,421,407,14
"N00000714",453,434,0,19,0,28,5,5,0,0,0,0,19,0,0,19,0,28,448,429,19
"N00000715",656,607,1,46,1,40,12,11,1,0,1,0,49,0,1,47,1,40,644,596,48
"N00000716",897,844,0,47,5,59,22,21,1,0,1,0,53,2,0,48,5,61,875,823,52
"N00000717",576,529,0,37,9,27,6,5,1,0,0,1,47,0,0,37,10,27,570,524,46
"N00000718",1923,1710,17,186,9,126,28,27,1,0,1,0,213,0,17,187,9,126,1895,1683,212
"N00000719",260,253,0,7,0,18,3,3,0,0,0,0,7,0,0,7,0,18,257,250,7
"N00000720",484,446,0,34,3,21,2,1,1,0,0,1,38,0,0,34,4,21,482,445,37
"N00000721",460,429,1,28,2,16,0,0,0,0,0,0,31,2,1,28,2,18,460,429,31
"N00000722",495,473,4,16,1,22,3,2,1,0,1,0,22,0,4,17,1,22,492,471,21
"N00000723",445,426,3,13,3,22,4,4,0,0,0,0,19,1,3,13,3,23,441,422,19
"N00000724",495,471,2,21,0,12,1,0,1,0,1,0,24,0,2,22,0,12,494,471,23
"N00000725",477,448,4,23,2,11,1,1,0,0,0,0,29,0,4,23,2,11,476,447,29
"N00000726",445,430,1,14,0,3,0,0,0,0,0,0,15,0,1,14,0,3,445,430,15
"N00000727",274,254,0,20,0,23,0,0,0,0,0,0,20,0,0,20,0,23,274,254,20
"N00000728",495,439,0,56,0,70,5,5,0,0,0,0,56,1,0,56,0,71,490,434,56
"N00000729",355,333,6,15,1,28,9,9,0,0,0,0,22,0,6,15,1,28,346,324,22
"N00000730",305,280,0,25,0,25,0,0,0,0,0,0,25,0,0,25,0,25,305,280,25
"N00000731",267,248,4,15,0,16,0,0,0,0,0,0,19,0,4,15,0,16,267,248,19
"N00000732",569,493,4,70,1,68,11,10,1,0,1,0,76,0,4,71,1,68,558,483,75
"N00000733",325,317,0,5,3,20,3,3,0,0,0,0,8,0,0,5,3,20,322,314,8
"N00000734",416,386,0,27,3,27,1,1,0,0,0,0,30,0,0,27,3,27,415,385,30
"N00000735",422,411,0,10,1,26,4,4,0,0,0,0,11,0,0,10,1,26,418,407,11
"N00000736",382,345,1,35,1,31,1,1,0,0,0,0,37,0,1,35,1,31,381,344,37
"N00000737",382,369,0,8,5,19,0,0,0,0,0,0,13,0,0,8,5,19,382,369,13
"N00000738",432,411,0,20,0,19,2,1,1,0,1,0,21,0,0,21,0,19,430,410,20
"N00000739",444,427,5,11,1,16,1,1,0,0,0,0,17,0,5,11,1,16,443,426,17
"N00000740",567,544,1,21,0,37,12,11,1,0,0,1,23,3,1,21,1,40,555,533,22
"N00000741",345,328,0,17,0,16,0,0,0,0,0,0,17,1,0,17,0,17,345,328,17
"N00000742",286,269,0,16,1,25,8,8,0,0,0,0,17,0,0,16,1,25,278,261,17
"N00000743",270,246,2,19,0,31,11,8,3,0,3,0,24,0,2,22,0,31,259,238,21
"N00000744",283,249,0,34,0,20,6,6,0,0,0,0,34,0,0,34,0,20,277,243,34
"N00000745",470,427,0,43,0,27,1,1,0,0,0,0,43,1,0,43,0,28,469,426,43
"N00000746",508,446,2,56,4,29,3,3,0,0,0,0,62,3,2,56,4,32,505,443,62
"N00000747",401,342,0,58,1,24,4,4,0,0,0,0,59,0,0,58,1,24,397,338,59
"N00000748",454,406,0,45,0,17,3,0,3,0,3,0,48,0,0,48,0,17,451,406,45
"N00000749",387,356,0,29,2,38,0,0,0,0,0,0,31,0,0,29,2,38,387,356,31
"N00000750",319,272,0,39,8,27,2,2,0,0,0,0,47,5,0,39,8,32,317,270,47
"N00000751",464,404,8,47,4,37,2,1,1,0,1,0,60,1,8,48,4,38,462,403,59
"N00000752",412,381,0,31,0,41,10,10,0,0,0,0,31,0,0,31,0,41,402,371,31
"N00000753",436,416,0,19,0,15,7,6,1,0,1,0,20,0,0,20,0,15,429,410,19
"N00000754",436,408,0,27,0,34,3,2,1,0,1,0,28,0,0,28,0,34,433,406,27
"N00000755",391,366,9,16,0,21,0,0,0,0,0,0,25,0,9,16,0,21,391,366,25
"N00000756",366,339,2,23,2,52,6,6,0,0,0,0,27,3,2,23,2,55,360,333,27
"N00000757",451,430,0,20,1,25,1,1,0,0,0,0,21,0,0,20,1,25,450,429,21
"N00000758",471,358,4,107,0,15,5,3,2,0,2,0,113,0,4,109,0,15,466,355,111
"N00000759",304,291,0,13,0,9,3,3,0,0,0,0,13,0,0,13,0,9,301,288,13
"N00000760",250,219,0,31,0,17,2,2,0,0,0,0,31,0,0,31,0,17,248,217,31
"N00000761",421,382,0,38,1,31,6,6,0,0,0,0,39,1,0,38,1,32,415,376,39
"N00000762",222,201,0,21,0,25,2,2,0,0,0,0,21,4,0,21,0,29,220,199,21
"N00000763",410,356,0,54,0,23,1,1,0,0,0,0,54,2,0,54,0,25,409,355,54
"N00000764",278,264,0,12,2,14,0,0,0,0,0,0,14,0,0,12,2,14,278,264,14
"N00000765",413,379,4,30,0,37,0,0,0,0,0,0,34,1,4,30,0,38,413,379,34
"N00000766",776,737,3,34,2,49,3,3,0,0,0,0,39,0,3,34,2,49,773,734,39
"N00000767",312,297,0,15,0,27,8,8,0,0,0,0,15,0,0,15,0,27,304,289,15
"N00000768",276,264,0,12,0,25,3,3,0,0,0,0,12,0,0,12,0,25,273,261,12
"N00000769",393,385,0,5,3,18,0,0,0,0,0,0,8,0,0,5,3,18,393,385,8
"N00000770",374,363,0,8,3,17,5,5,0,0,0,0,11,0,0,8,3,17,369,358,11
"N00000771",233,217,0,16,0,22,0,0,0,0,0,0,16,0,0,16,0,22,233,217,16
"N00000772",456,440,0,16,0,12,1,1,0,0,0,0,16,0,0,16,0,12,455,439,16
"N00000773",420,395,0,24,0,33,1,0,1,0,1,0,25,1,0,25,0,34,419,395,24
"N00000774",1023,936,16,63,8,76,7,7,0,0,0,0,87,0,16,63,8,76,1016,929,87
"N00000775",296,287,0,9,0,11,4,4,0,0,0,0,9,0,0,9,0,11,292,283,9
"N00000776",327,304,2,21,0,27,2,2,0,0,0,0,23,0,2,21,0,27,325,302,23
"N00000777",912,871,5,27,8,46,16,15,1,0,1,0,41,1,5,28,8,47,896,856,40
"N00000778",432,412,3,17,0,42,1,1,0,0,0,0,20,0,3,17,0,42,431,411,20
"N00000779",564,525,1,38,0,42,3,3,0,0,0,0,39,0,1,38,0,42,561,522,39
"N00000780",531,506,4,18,3,48,7,7,0,0,0,0,25,0,4,18,3,48,524,499,25
"N00000781",508,466,1,39,2,35,10,10,0,0,0,0,42,0,1,39,2,35,498,456,42
"N00000782",526,508,2,16,0,14,1,1,0,0,0,0,18,0,2,16,0,14,525,507,18
"N00000783",565,540,11,14,0,22,0,0,0,0,0,0,25,0,11,14,0,22,565,540,25
"N00000784",437,414,0,20,3,18,0,0,0,0,0,0,23,0,0,20,3,18,437,414,23
"N00000785",332,311,1,19,1,35,1,1,0,0,0,0,21,0,1,19,1,35,331,310,21
"N00000786",384,377,0,5,2,10,2,2,0,0,0,0,7,0,0,5,2,10,382,375,7
"N00000787",437,411,0,25,0,19,4,3,1,0,1,0,26,2,0,26,0,21,433,408,25
"N00000788",427,397,3,26,1,26,4,4,0,0,0,0,30,0,3,26,1,26,423,393,30
"N00000789",997,907,9,77,4,55,6,6,0,0,0,0,90,1,9,77,4,56,991,901,90
"N00000790",530,497,0,32,1,42,1,1,0,0,0,0,33,0,0,32,1,42,529,496,33
"N00000791",347,327,0,17,1,9,5,3,2,0,2,0,20,0,0,19,1,9,342,324,18
"N00000792",399,381,0,13,5,15,2,2,0,0,0,0,18,0,0,13,5,15,397,379,18
"N00000793",451,432,0,18,1,17,1,1,0,0,0,0,19,0,0,18,1,17,450,431,19
"N00000794",467,444,0,23,0,24,1,1,0,0,0,0,23,0,0,23,0,24,466,443,23
"N00000795",539,514,1,24,0,9,0,0,0,0,0,0,25,0,1,24,0,9,539,514,25
"N00000796",351,324,0,24,3,26,1,1,0,0,0,0,27,0,0,24,3,26,350,323,27
"N00000797",349,325,5,18,1,17,0,0,0,0,0,0,24,0,5,18,1,17,349,325,24
"N00000798",527,511,1,15,0,11,10,10,0,0,0,0,16,0,1,15,0,11,517,501,16
"N00000799",475,448,1,26,0,11,5,5,0,0,0,0,27,0,1,26,0,11,470,443,27
"N00000800",428,424,0,4,0,34,1,1,0,0,0,0,4,0,0,4,0,34,427,423,4
"N00000801",529,512,0,17,0,32,2,2,0,0,0,0,17,1,0,17,0,33,527,510,17
"N00000802",272,252,0,18,2,44,0,0,0,0,0,0,20,1,0,18,2,45,272,252,20
"N00000803",398,378,1,18,1,34,0,0,0,0,0,0,20,0,1,18,1,34,398,378,20
"N00000804",422,405,0,17,0,21,0,0,0,0,0,0,17,0,0,17,0,21,422,405,17
"N00000805",383,370,0,11,2,8,0,0,0,0,0,0,13,0,0,11,2,8,383,370,13
"N00000806",341,330,1,9,1,18,1,1,0,0,0,0,11,2,1,9,1,20,340,329,11
"N00000807",521,466,4,48,3,35,3,3,0,0,0,0,55,0,4,48,3,35,518,463,55
"N00000808",243,224,0,19,0,22,2,2,0,0,0,0,19,0,0,19,0,22,241,222,19
"N00000809",557,479,0,78,0,45,4,4,0,0,0,0,78,0,0,78,0,45,553,475,78
"N00000810",434,405,2,25,1,16,6,5,1,0,0,1,29,0,2,25,2,16,428,400,28
"N00000811",345,317,2,18,8,31,3,3,0,0,0,0,28,0,2,18,8,31,342,314,28
"N00000812",299,288,0,10,1,21,2,2,0,0,0,0,11,0,0,10,1,21,297,286,11
"N00000813",491,457,0,32,1,54,7,6,1,0,0,1,34,0,0,32,2,54,484,451,33
"N00000814",258,244,3,11,0,24,0,0,0,0,0,0,14,0,3,11,0,24,258,244,14
"N00000815",487,462,0,23,2,44,4,4,0,0,0,0,25,0,0,23,2,44,483,458,25
"N00000816",558,495,0,61,2,29,0,0,0,0,0,0,63,0,0,61,2,29,558,495,63
"N00000817",256,251,0,4,1,11,2,2,0,0,0,0,5,0,0,4,1,11,254,249,5
"N00000818",324,311,2,11,0,32,0,0,0,0,0,0,13,0,2,11,0,32,324,311,13
"N00000819",253,226,0,27,0,25,0,0,0,0,0,0,27,0,0,27,0,25,253,226,27
"N00000820",375,332,3,37,2,59,3,2,1,0,1,0,43,0,3,38,2,59,372,330,42
"N00000821",269,252,0,14,0,17,9,6,3,0,3,0,17,0,0,17,0,17,260,246,14
"N00000822",209,195,1,11,2,19,0,0,0,0,0,0,14,0,1,11,2,19,209,195,14
"N00000823",365,340,0,23,0,18,13,11,2,0,2,0,25,0,0,25,0,18,352,329,23
"N00000824",253,209,2,39,2,40,1,0,1,1,0,0,44,0,3,39,2,40,252,209,43
"N00000825",367,351,2,10,2,26,3,1,2,0,2,0,16,0,2,12,2,26,364,350,14
"N00000826",302,291,0,11,0,11,0,0,0,0,0,0,11,0,0,11,0,11,302,291,11
"N00000827",298,284,0,13,1,7,0,0,0,0,0,0,14,0,0,13,1,7,298,284,14
"N00000828",231,226,0,5,0,23,0,0,0,0,0,0,5,1,0,5,0,24,231,226,5
"N00000829",310,302,0,8,0,22,1,1,0,0,0,0,8,1,0,8,0,23,309,301,8
"N00000830",260,248,0,11,1,11,1,1,0,0,0,0,12,0,0,11,1,11,259,247,12
"N00000831",306,291,0,15,0,12,0,0,0,0,0,0,15,0,0,15,0,12,306,291,15
"N00000832",273,266,0,7,0,39,0,0,0,0,0,0,7,0,0,7,0,39,273,266,7
"N00000833",253,242,0,10,1,18,9,9,0,0,0,0,11,0,0,10,1,18,244,233,11
"N00000834",390,367,0,23,0,27,12,12,0,0,0,0,23,0,0,23,0,27,378,355,23
"N00000835",301,281,0,19,1,13,1,1,0,0,0,0,20,0,0,19,1,13,300,280,20
"N00000836",347,323,0,24,0,21,0,0,0,0,0,0,24,2,0,24,0,23,347,323,24
"N00000837",351,340,0,4,3,7,4,0,4,0,4,0,11,0,0,8,3,7,347,340,7
"N00000838",283,262,0,21,0,23,3,3,0,0,0,0,21,0,0,21,0,23,280,259,21
"N00000839",363,338,0,25,0,26,5,5,0,0,0,0,25,0,0,25,0,26,358,333,25
"N00000840",272,252,0,16,3,20,1,0,1,0,0,1,20,0,0,16,4,20,271,252,19
"N00000841",295,266,2,27,0,21,2,2,0,0,0,0,29,0,2,27,0,21,293,264,29
"N00000842",556,531,0,20,0,49,11,6,5,0,1,4,25,4,0,21,4,53,545,525,20
"N00000843",233,216,0,17,0,16,0,0,0,0,0,0,17,0,0,17,0,16,233,216,17
"N00000844",213,196,0,17,0,29,0,0,0,0,0,0,17,2,0,17,0,31,213,196,17
"N00000845",202,180,0,20,2,25,1,1,0,0,0,0,22,0,0,20,2,25,201,179,22
"N00000846",246,229,0,16,0,33,1,0,1,0,1,0,17,5,0,17,0,38,245,229,16
"N00000847",958,855,1,98,1,54,8,5,3,0,3,0,103,0,1,101,1,54,950,850,100
"N00000848",240,221,0,18,1,24,0,0,0,0,0,0,19,0,0,18,1,24,240,221,19
"N00000849",307,286,0,20,1,20,1,1,0,0,0,0,21,0,0,20,1,20,306,285,21
"N00000850",270,244,0,22,2,8,3,1,2,0,2,0,26,0,0,24,2,8,267,243,24
"N00000851",243,211,0,32,0,28,1,1,0,0,0,0,32,0,0,32,0,28,242,210,32
"N00000852",1179,1060,19,97,2,81,10,9,1,0,1,0,119,0,19,98,2,81,1169,1051,118
"N00000853",282,241,0,41,0,40,0,0,0,0,0,0,41,5,0,41,0,45,282,241,41
"N00000854",763,704,7,47,1,61,10,6,4,0,4,0,59,2,7,51,1,63,753,698,55
"N00000855",169,147,0,13,1,24,16,8,8,0,7,1,22,1,0,20,2,25,153,139,14
"N00000856",182,161,0,17,4,7,5,5,0,0,0,0,21,0,0,17,4,7,177,156,21
"N00000857",386,347,0,36,1,37,13,11,2,0,2,0,39,1,0,38,1,38,373,336,37
"N00000858",239,207,2,26,0,27,16,12,4,0,4,0,32,4,2,30,0,31,223,195,28
"N00000859",287,252,2,26,0,22,34,27,7,0,7,0,35,6,2,33,0,28,253,225,28
"N00000860",437,391,0,44,1,28,8,7,1,0,1,0,46,3,0,45,1,31,429,384,45
"N00000861",303,284,2,16,0,23,6,5,1,0,1,0,19,0,2,17,0,23,297,279,18
"N00000862",876,772,0,90,9,89,45,40,5,0,3,2,104,12,0,93,11,101,831,732,99
"N00000863",294,280,2,12,0,11,11,11,0,0,0,0,14,0,2,12,0,11,283,269,14
"N00000864",305,285,0,15,1,18,19,15,4,0,1,3,20,5,0,16,4,23,286,270,16
"N00000865",358,332,0,24,0,40,14,12,2,0,1,1,26,2,0,25,1,42,344,320,24
"N00000866",342,275,0,57,2,31,32,24,8,0,8,0,67,10,0,65,2,41,310,251,59
"N00000867",288,236,1,44,2,85,25,20,5,2,3,0,52,5,3,47,2,90,263,216,47
"N00000868",297,274,0,22,1,41,5,5,0,0,0,0,23,1,0,22,1,42,292,269,23
"N00000869",186,162,0,18,1,11,14,9,5,0,3,2,24,1,0,21,3,12,172,153,19
"N00000870",394,347,0,46,1,22,12,12,0,0,0,0,47,0,0,46,1,22,382,335,47
"N00000871",340,312,0,21,5,19,12,10,2,0,2,0,28,1,0,23,5,20,328,302,26
"N00000872",256,220,1,34,1,18,10,10,0,0,0,0,36,0,1,34,1,18,246,210,36
"N00000873",322,298,0,23,1,24,3,3,0,0,0,0,24,0,0,23,1,24,319,295,24
"N00000874",533,435,1,64,10,59,52,29,23,1,5,17,98,15,2,69,27,74,481,406,75
"N00000875",284,266,1,16,0,22,4,3,1,0,1,0,18,1,1,17,0,23,280,263,17
"N00000876",212,197,0,15,0,16,1,1,0,0,0,0,15,0,0,15,0,16,211,196,15
"N00000877",357,333,1,21,0,18,7,5,2,0,1,1,24,0,1,22,1,18,350,328,22
"N00000878",234,216,0,18,0,9,1,1,0,0,0,0,18,2,0,18,0,11,233,215,18
"N00000879",1015,955,20,37,1,55,9,7,2,0,2,0,60,1,20,39,1,56,1006,948,58
"N00000880",315,295,0,19,0,20,2,1,1,0,1,0,20,0,0,20,0,20,313,294,19
"N00000881",296,264,0,30,2,11,5,5,0,0,0,0,32,0,0,30,2,11,291,259,32
"N00000882",253,218,0,31,1,25,10,7,3,0,3,0,35,2,0,34,1,27,243,211,32
"N00000883",264,245,0,15,0,17,6,2,4,0,4,0,19,0,0,19,0,17,258,243,15
"N00000884",205,187,0,14,0,12,11,7,4,0,4,0,18,0,0,18,0,12,194,180,14
"N00000885",618,514,6,80,10,85,28,20,8,0,7,1,104,6,6,87,11,91,590,494,96
"N00000886",253,183,0,49,10,35,21,10,11,0,11,0,70,5,0,60,10,40,232,173,59
"N00000887",308,266,0,32,6,27,9,5,4,0,3,1,42,1,0,35,7,28,299,261,38
"N00000888",308,241,0,51,3,37,34,21,13,0,13,0,67,1,0,64,3,38,274,220,54
"N00000889",259,230,0,24,3,42,20,18,2,0,2,0,29,11,0,26,3,53,239,212,27
"N00000890",339,288,0,46,3,29,13,11,2,0,2,0,51,2,0,48,3,31,326,277,49
"N00000891",346,275,0,61,7,55,20,17,3,1,2,0,71,0,1,63,7,55,326,258,68
"N00000892",318,270,0,40,4,43,10,6,4,0,4,0,48,0,0,44,4,43,308,264,44
"N00000893",284,214,3,53,5,42,21,12,9,0,9,0,70,6,3,62,5,48,263,202,61
"N00000894",263,227,0,27,7,42,10,8,2,0,2,0,36,9,0,29,7,51,253,219,34
"N00000895",272,237,1,26,2,40,28,22,6,0,6,0,35,1,1,32,2,41,244,215,29
"N00000896",265,215,0,40,2,41,24,16,8,0,8,0,50,3,0,48,2,44,241,199,42
"N00000897",300,220,2,59,13,71,20,14,6,0,3,3,80,8,2,62,16,79,280,206,74
"N00000898",307,242,0,59,2,33,11,7,4,0,4,0,65,0,0,63,2,33,296,235,61
"N00000899",306,238,0,53,4,37,26,15,11,0,10,1,68,1,0,63,5,38,280,223,57
"N00000900",216,188,0,20,0,19,31,23,8,0,8,0,28,10,0,28,0,29,185,165,20
"N00000901",313,208,2,79,18,80,14,8,6,0,5,1,105,10,2,84,19,90,299,200,99
"N00000902",294,193,0,84,6,28,31,20,11,0,9,2,101,1,0,93,8,29,263,173,90
"N00000903",206,159,0,11,4,3,88,56,32,0,26,6,47,19,0,37,10,22,118,103,15
"N00000904",446,320,2,101,11,53,30,18,12,0,10,2,126,2,2,111,13,55,416,302,114
"N00000905",325,277,2,39,4,35,16,13,3,0,2,1,48,0,2,41,5,35,309,264,45
"N00000906",263,240,0,20,0,29,7,4,3,0,3,0,23,0,0,23,0,29,256,236,20
"N00000907",332,319,0,13,0,13,10,10,0,0,0,0,13,0,0,13,0,13,322,309,13
"N00000908",329,295,2,32,0,21,4,4,0,0,0,0,34,0,2,32,0,21,325,291,34
"N00000909",246,240,2,4,0,8,2,2,0,0,0,0,6,0,2,4,0,8,244,238,6
"N00000910",273,251,0,19,3,26,5,5,0,0,0,0,22,0,0,19,3,26,268,246,22
"N00000911",239,220,0,19,0,21,0,0,0,0,0,0,19,0,0,19,0,21,239,220,19
"N00000912",243,227,0,15,1,7,12,12,0,0,0,0,16,0,0,15,1,7,231,215,16
"N00000913",321,305,6,10,0,20,5,5,0,0,0,0,16,0,6,10,0,20,316,300,16
"N00000914",294,279,0,14,1,17,6,6,0,0,0,0,15,0,0,14,1,17,288,273,15
"N00000915",214,198,0,15,1,19,1,1,0,0,0,0,16,0,0,15,1,19,213,197,16
"N00000916",234,210,3,18,0,14,8,5,3,0,0,3,24,1,3,18,3,15,226,205,21
"N00000917",226,215,0,11,0,3,0,0,0,0,0,0,11,0,0,11,0,3,226,215,11
"N00000918",261,243,1,15,2,16,1,1,0,0,0,0,18,0,1,15,2,16,260,242,18
"N00000919",229,212,0,17,0,11,13,13,0,0,0,0,17,0,0,17,0,11,216,199,17
"N00000920",148,141,0,4,3,3,10,10,0,0,0,0,7,0,0,4,3,3,138,131,7
"N00000921",713,683,0,27,0,42,15,12,3,0,3,0,30,1,0,30,0,43,698,671,27
"N00000922",292,277,0,9,2,7,8,4,4,0,4,0,15,1,0,13,2,8,284,273,11
"N00000923",257,229,1,22,4,26,8,7,1,0,1,0,28,0,1,23,4,26,249,222,27
"N00000924",224,215,0,9,0,17,4,4,0,0,0,0,9,1,0,9,0,18,220,211,9
"N00000925",288,280,0,7,1,16,5,5,0,0,0,0,8,0,0,7,1,16,283,275,8
"N00000926",284,251,4,28,1,17,7,7,0,0,0,0,33,8,4,28,1,25,277,244,33
"N00000927",421,385,1,24,4,30,148,141,7,0,4,3,36,24,1,28,7,54,273,244,29
"N00000928",356,324,1,26,1,58,10,6,4,0,4,0,32,1,1,30,1,59,346,318,28
"N00000929",437,381,0,46,2,20,19,11,8,0,8,0,56,0,0,54,2,20,418,370,48
"N00000930",364,337,2,23,2,58,6,6,0,0,0,0,27,0,2,23,2,58,358,331,27
"N00000931",682,633,4,42,0,54,17,14,3,0,3,0,49,1,4,45,0,55,665,619,46
"N00000932",419,361,1,56,0,25,39,38,1,0,0,1,58,2,1,56,1,27,380,323,57
"N00000933",288,258,0,29,1,45,19,19,0,0,0,0,30,2,0,29,1,47,269,239,30
"N00000934",282,265,0,16,1,15,13,13,0,0,0,0,17,1,0,16,1,16,269,252,17
"N00000935",251,212,0,35,0,10,12,8,4,0,1,3,39,0,0,36,3,10,239,204,35
"N00000936",473,454,2,15,2,14,3,3,0,0,0,0,19,0,2,15,2,14,470,451,19
"N00000937",433,397,0,35,0,19,4,3,1,0,1,0,36,9,0,36,0,28,429,394,35
"N00000938",345,326,0,11,6,18,2,0,2,0,0,2,19,0,0,11,8,18,343,326,17
"N00000939",198,183,0,14,1,17,3,3,0,0,0,0,15,6,0,14,1,23,195,180,15
"N00000940",252,237,0,12,0,44,13,10,3,0,3,0,15,0,0,15,0,44,239,227,12
"N00000941",343,321,0,20,0,19,3,1,2,0,1,1,22,0,0,21,1,19,340,320,20
"N00000942",280,272,0,6,2,12,1,1,0,0,0,0,8,0,0,6,2,12,279,271,8
"N00000943",272,265,0,7,0,13,7,7,0,0,0,0,7,2,0,7,0,15,265,258,7
"N00000944",245,232,0,9,2,12,10,8,2,0,2,0,13,0,0,11,2,12,235,224,11
"N00000945",254,245,0,9,0,11,0,0,0,0,0,0,9,0,0,9,0,11,254,245,9
"N00000946",386,331,1,51,0,44,13,10,3,0,3,0,55,5,1,54,0,49,373,321,52
"N00000947",248,237,0,8,3,9,0,0,0,0,0,0,11,0,0,8,3,9,248,237,11
"N00000948",225,193,0,31,1,21,0,0,0,0,0,0,32,1,0,31,1,22,225,193,32
"N00000949",314,278,1,34,0,25,9,8,1,0,0,1,36,0,1,34,1,25,305,270,35
"N00000950",317,274,0,37,2,56,9,5,4,0,3,1,43,3,0,40,3,59,308,269,39
"N00000951",240,219,1,20,0,30,2,2,0,0,0,0,21,0,1,20,0,30,238,217,21
"N00000952",391,344,0,41,0,14,19,13,6,0,2,4,47,0,0,43,4,14,372,331,41
"N00000953",238,215,2,20,1,24,0,0,0,0,0,0,23,0,2,20,1,24,238,215,23
"N00000954",275,256,1,15,1,11,7,5,2,0,0,2,19,0,1,15,3,11,268,251,17
"N00000955",394,370,0,19,3,30,4,2,2,0,2,0,24,0,0,21,3,30,390,368,22
"N00000956",488,416,5,59,3,57,7,2,5,0,4,1,72,5,5,63,4,62,481,414,67
"N00000957",555,514,7,32,1,28,1,0,1,0,0,1,41,0,7,32,2,28,554,514,40
"N00000958",294,268,0,25,0,12,7,6,1,0,1,0,26,0,0,26,0,12,287,262,25
"N00000959",476,451,0,25,0,48,12,12,0,0,0,0,25,0,0,25,0,48,464,439,25
"N00000960",515,465,0,46,1,54,14,11,3,0,2,1,50,0,0,48,2,54,501,454,47
"N00000961",311,293,0,13,3,11,2,0,2,0,1,1,18,0,0,14,4,11,309,293,16
"N00000962",338,316,0,19,1,22,9,7,2,2,0,0,22,0,2,19,1,22,329,309,20
"N00000963",252,237,0,14,0,6,7,6,1,0,1,0,15,0,0,15,0,6,245,231,14
"N00000964",297,277,0,15,3,12,2,0,2,0,2,0,20,0,0,17,3,12,295,277,18
"N00000965",300,267,0,32,1,30,0,0,0,0,0,0,33,0,0,32,1,30,300,267,33
"N00000966",331,305,0,22,2,14,3,1,2,0,2,0,26,3,0,24,2,17,328,304,24
"N00000967",378,347,0,27,0,24,30,26,4,0,4,0,31,1,0,31,0,25,348,321,27
"N00000968",255,237,0,11,0,35,8,1,7,0,6,1,18,0,0,17,1,35,247,236,11
"N00000969",193,186,0,7,0,6,10,10,0,0,0,0,7,3,0,7,0,9,183,176,7
"N00000970",486,420,3,55,5,46,9,6,3,0,3,0,66,1,3,58,5,47,477,414,63
"N00000971",261,234,2,25,0,25,2,2,0,0,0,0,27,0,2,25,0,25,259,232,27
"N00000972",317,297,0,20,0,10,5,5,0,0,0,0,20,3,0,20,0,13,312,292,20
"N00000973",331,275,0,52,1,51,6,3,3,0,3,0,56,2,0,55,1,53,325,272,53
"N00000974",275,232,0,42,1,31,3,3,0,0,0,0,43,0,0,42,1,31,272,229,43
"N00000975",262,225,0,31,2,39,12,8,4,0,2,2,37,2,0,33,4,41,250,217,33
"N00000976",141,132,0,7,1,68,9,8,1,0,0,1,9,0,0,7,2,68,132,124,8
"N00000977",285,252,0,27,3,13,9,6,3,0,3,0,33,2,0,30,3,15,276,246,30
"N00000978",239,202,2,30,5,69,2,2,0,0,0,0,37,0,2,30,5,69,237,200,37
"N00000979",217,168,0,39,8,26,3,1,2,0,2,0,49,1,0,41,8,27,214,167,47
"N00000980",223,166,1,41,5,53,16,6,10,0,5,5,57,9,1,46,10,62,207,160,47
"N00000981",207,167,0,32,7,38,9,8,1,0,0,1,40,0,0,32,8,38,198,159,39
"N00000982",252,201,0,33,17,28,6,5,1,0,1,0,51,4,0,34,17,32,246,196,50
"N00000983",336,308,3,20,3,22,3,1,2,0,2,0,28,1,3,22,3,23,333,307,26
"N00000984",329,215,0,102,6,66,18,12,6,0,4,2,114,2,0,106,8,68,311,203,108
"N00000985",244,210,0,33,1,19,1,1,0,0,0,0,34,0,0,33,1,19,243,209,34
"N00000986",214,166,1,43,3,55,6,5,1,0,1,0,48,2,1,44,3,57,208,161,47
"N00000987",367,276,2,76,7,21,10,4,6,0,5,1,91,5,2,81,8,26,357,272,85
"N00000988",146,116,0,27,3,35,3,3,0,0,0,0,30,0,0,27,3,35,143,113,30
"N00000989",262,229,0,29,0,39,8,4,4,0,4,0,33,2,0,33,0,41,254,225,29
"N00000990",274,193,2,70,3,35,16,10,6,0,6,0,81,7,2,76,3,42,258,183,75
"N00000991",269,207,0,58,3,29,3,2,1,0,1,0,62,3,0,59,3,32,266,205,61
"N00000992",462,388,0,62,3,70,16,7,9,0,3,6,74,2,0,65,9,72,446,381,65
"N00000993",236,204,0,23,7,27,11,9,2,0,2,0,32,3,0,25,7,30,225,195,30
"N00000994",928,789,3,113,17,114,32,26,6,0,6,0,139,7,3,119,17,121,896,763,133
"N00000995",195,182,0,10,3,18,1,1,0,0,0,0,13,0,0,10,3,18,194,181,13
"N00000996",383,349,0,31,1,24,5,3,2,0,2,0,34,0,0,33,1,24,378,346,32
"N00000997",271,248,0,20,2,32,3,2,1,0,1,0,23,2,0,21,2,34,268,246,22
"N00000998",304,274,0,27,2,13,10,9,1,0,0,1,30,0,0,27,3,13,294,265,29
"N00000999",227,182,0,33,6,15,10,4,6,0,0,6,45,4,0,33,12,19,217,178,39
"N00001000",307,275,0,30,1,24,1,0,1,0,1,0,32,0,0,31,1,24,306,275,31
"N00001001",296,249,0,35,7,62,22,17,5,0,5,0,47,1,0,40,7,63,274,232,42
"N00001002",796,686,2,90,14,102,10,6,4,0,4,0,110,10,2,94,14,112,786,680,106
"N00001003",218,187,0,31,0,17,8,8,0,0,0,0,31,1,0,31,0,18,210,179,31
"N00001004",303,259,0,39,2,40,20,17,3,0,3,0,44,4,0,42,2,44,283,242,41
"N00001005",258,200,0,54,1,39,9,6,3,0,3,0,58,0,0,57,1,39,249,194,55
"N00001006",527,202,3,269,20,284,55,22,33,0,20,13,325,72,3,289,33,356,472,180,292
"N00001007",595,271,0,264,19,123,75,34,41,0,34,7,324,20,0,298,26,143,520,237,283
"N00001008",245,108,1,122,7,113,19,12,7,0,7,0,137,9,1,129,7,122,226,96,130
"N00001009",188,95,0,65,9,71,34,15,19,0,14,5,93,22,0,79,14,93,154,80,74
"N00001010",334,101,1,198,21,113,21,8,13,0,10,3,233,4,1,208,24,117,313,93,220
"N00001011",374,123,0,231,1,70,26,7,19,0,18,1,251,1,0,249,2,71,348,116,232
"N00001012",353,173,1,159,5,51,24,9,15,1,9,5,180,6,2,168,10,57,329,164,165
"N00001013",242,136,2,96,4,89,11,7,4,0,4,0,106,5,2,100,4,94,231,129,102
"N00001014",239,80,0,135,11,107,18,5,13,0,6,7,159,12,0,141,18,119,221,75,146
"N00001015",416,141,2,237,12,126,35,11,24,0,23,1,275,27,2,260,13,153,381,130,251
"N00001016",262,111,0,134,10,93,20,13,7,0,6,1,151,13,0,140,11,106,242,98,144
"N00001017",323,129,0,174,12,72,20,12,8,0,6,2,194,7,0,180,14,79,303,117,186
"N00001018",288,195,0,76,8,57,30,21,9,0,8,1,93,2,0,84,9,59,258,174,84
"N00001019",205,87,0,106,2,51,20,10,10,0,4,6,118,4,0,110,8,55,185,77,108
"N00001020",171,110,2,49,6,58,19,15,4,0,2,2,61,44,2,51,8,102,152,95,57
"N00001021",239,96,0,130,4,129,20,11,9,0,6,3,143,8,0,136,7,137,219,85,134
"N00001022",604,286,2,225,27,201,98,34,64,0,34,30,318,40,2,259,57,241,506,252,254
"N00001023",220,89,2,116,6,103,15,8,7,0,6,1,131,9,2,122,7,112,205,81,124
"N00001024",346,112,3,200,14,137,27,10,17,0,16,1,234,4,3,216,15,141,319,102,217
"N00001025",297,83,0,181,14,81,30,11,19,0,5,14,214,11,0,186,28,92,267,72,195
"N00001026",236,110,0,102,10,56,30,16,14,0,10,4,126,8,0,112,14,64,206,94,112
"N00001027",395,282,8,87,7,87,24,13,11,0,10,1,113,5,8,97,8,92,371,269,102
"N00001028",261,243,0,16,0,18,5,3,2,0,2,0,18,0,0,18,0,18,256,240,16
"N00001029",699,607,0,56,9,59,50,23,27,0,19,8,92,18,0,75,17,77,649,584,65
"N00001030",514,335,1,145,15,98,44,26,18,0,13,5,179,10,1,158,20,108,470,309,161
"N00001031",372,285,0,68,11,28,22,14,8,0,4,4,87,1,0,72,15,29,350,271,79
"N00001032",185,174,1,9,1,5,1,1,0,0,0,0,11,0,1,9,1,5,184,173,11
"N00001033",129,116,0,12,1,9,2,2,0,0,0,0,13,0,0,12,1,9,127,114,13
"N00001034",344,327,0,13,1,23,9,6,3,0,1,2,17,1,0,14,3,24,335,321,14
"N00001035",284,240,5,31,8,13,1,1,0,0,0,0,44,0,5,31,8,13,283,239,44
"N00001036",391,354,0,30,0,22,37,30,7,0,6,1,37,16,0,36,1,38,354,324,30
"N00001037",368,340,0,21,2,22,12,7,5,0,4,1,28,0,0,25,3,22,356,333,23
"N00001038",726,690,0,32,3,38,5,4,1,0,0,1,36,1,0,32,4,39,721,686,35
"N00001039",387,347,0,36,4,30,3,3,0,0,0,0,40,0,0,36,4,30,384,344,40
"N00001040",271,239,0,30,2,17,0,0,0,0,0,0,32,0,0,30,2,17,271,239,32
"N00001041",190,181,0,9,0,7,0,0,0,0,0,0,9,0,0,9,0,7,190,181,9
"N00001042",664,620,0,41,3,54,5,5,0,0,0,0,44,0,0,41,3,54,659,615,44
"N00001043",206,187,0,19,0,16,0,0,0,0,0,0,19,2,0,19,0,18,206,187,19
"N00001044",303,281,0,20,2,26,5,5,0,0,0,0,22,0,0,20,2,26,298,276,22
"N00001045",274,266,0,5,0,13,5,2,3,0,3,0,8,0,0,8,0,13,269,264,5
"N00001046",307,286,0,19,1,27,8,7,1,0,1,0,21,1,0,20,1,28,299,279,20
"N00001047",314,302,0,12,0,19,3,3,0,0,0,0,12,0,0,12,0,19,311,299,12
"N00001048",331,325,0,6,0,24,1,1,0,0,0,0,6,1,0,6,0,25,330,324,6
"N00001049",330,312,0,16,1,13,2,1,1,0,0,1,18,0,0,16,2,13,328,311,17
"N00001050",335,329,0,2,3,11,5,4,1,0,1,0,6,0,0,3,3,11,330,325,5
"N00001051",371,363,0,8,0,13,7,7,0,0,0,0,8,0,0,8,0,13,364,356,8
"N00001052",180,154,1,23,1,23,5,4,1,0,1,0,26,1,1,24,1,24,175,150,25
"N00001053",355,336,0,19,0,25,3,3,0,0,0,0,19,0,0,19,0,25,352,333,19
"N00001054",341,314,0,26,1,15,0,0,0,0,0,0,27,0,0,26,1,15,341,314,27
"N00001055",350,338,0,11,1,15,2,2,0,0,0,0,12,0,0,11,1,15,348,336,12
"N00001056",355,345,0,9,0,21,4,3,1,0,1,0,10,0,0,10,0,21,351,342,9
"N00001057",326,305,0,21,0,23,0,0,0,0,0,0,21,0,0,21,0,23,326,305,21
"N00001058",349,340,0,5,3,14,3,2,1,0,0,1,9,5,0,5,4,19,346,338,8
"N00001059",320,306,0,13,0,27,7,6,1,0,1,0,14,0,0,14,0,27,313,300,13
"N00001060",256,244,0,12,0,20,1,1,0,0,0,0,12,0,0,12,0,20,255,243,12
"N00001061",341,292,3,46,0,33,0,0,0,0,0,0,49,1,3,46,0,34,341,292,49
"N00001062",354,322,0,30,2,10,1,1,0,0,0,0,32,0,0,30,2,10,353,321,32
"N00001063",306,297,0,9,0,9,3,3,0,0,0,0,9,0,0,9,0,9,303,294,9
"N00001064",632,580,0,45,6,50,2,1,1,0,1,0,52,0,0,46,6,50,630,579,51
"N00001065",326,306,0,19,1,19,0,0,0,0,0,0,20,0,0,19,1,19,326,306,20
"N00001066",275,262,0,12,0,26,7,6,1,0,1,0,13,0,0,13,0,26,268,256,12
"N00001067",278,263,0,15,0,11,8,8,0,0,0,0,15,0,0,15,0,11,270,255,15
"N00001068",336,273,0,61,0,34,15,13,2,0,2,0,63,0,0,63,0,34,321,260,61
"N00001069",327,304,0,16,1,24,20,14,6,0,6,0,23,1,0,22,1,25,307,290,17
"N00001070",518,482,2,32,2,29,11,11,0,0,0,0,36,0,2,32,2,29,507,471,36
"N00001071",318,271,4,40,2,34,4,3,1,0,0,1,47,2,4,40,3,36,314,268,46
"N00001072",320,308,0,11,1,10,0,0,0,0,0,0,12,3,0,11,1,13,320,308,12
"N00001073",283,266,0,16,0,15,14,13,1,0,1,0,17,0,0,17,0,15,269,253,16
"N00001074",240,229,0,8,1,14,6,4,2,0,2,0,11,1,0,10,1,15,234,225,9
"N00001075",308,258,2,46,0,28,4,2,2,0,2,0,50,0,2,48,0,28,304,256,48
"N00001076",272,246,0,23,1,16,8,6,2,0,1,1,26,12,0,24,2,28,264,240,24
"N00001077",229,208,0,16,0,19,14,9,5,0,5,0,21,0,0,21,0,19,215,199,16
"N00001078",257,234,0,20,2,17,4,3,1,0,0,1,23,3,0,20,3,20,253,231,22
"N00001079",829,699,8,112,1,123,16,7,9,0,8,1,130,3,8,120,2,126,813,692,121
"N00001080",324,300,0,23,1,33,10,10,0,0,0,0,24,2,0,23,1,35,314,290,24
"N00001081",412,389,0,14,0,31,16,7,9,0,9,0,23,9,0,23,0,40,396,382,14
"N00001082",431,390,0,38,1,50,14,12,2,0,2,0,41,10,0,40,1,60,417,378,39
"N00001083",436,406,2,27,0,32,12,11,1,0,1,0,30,3,2,28,0,35,424,395,29
"N00001084",447,386,1,55,0,29,6,1,5,0,5,0,61,0,1,60,0,29,441,385,56
"N00001085",1087,984,5,79,13,72,25,19,6,1,5,0,103,2,6,84,13,74,1062,965,97
"N00001086",336,319,0,10,2,10,14,9,5,0,5,0,17,0,0,15,2,10,322,310,12
"N00001087",307,265,0,37,2,19,9,6,3,0,3,0,42,0,0,40,2,19,298,259,39
"N00001088",305,288,0,11,1,28,10,5,5,0,5,0,17,0,0,16,1,28,295,283,12
"N00001089",316,294,2,16,0,19,15,11,4,0,3,1,22,0,2,19,1,19,301,283,18
"N00001090",222,213,1,6,0,6,7,5,2,1,0,1,9,0,2,6,1,6,215,208,7
"N00001091",384,369,0,12,3,25,7,7,0,0,0,0,15,1,0,12,3,26,377,362,15
"N00001092",398,361,0,36,0,22,1,0,1,0,1,0,37,0,0,37,0,22,397,361,36
"N00001093",642,465,12,158,1,32,11,5,6,0,6,0,177,0,12,164,1,32,631,460,171
"N00001094",239,199,0,32,2,7,6,0,6,0,6,0,40,0,0,38,2,7,233,199,34
"N00001095",368,312,0,53,3,49,10,10,0,0,0,0,56,0,0,53,3,49,358,302,56
"N00001096",397,381,1,11,3,27,4,3,1,0,0,1,16,1,1,11,4,28,393,378,15
"N00001097",316,302,0,12,2,18,1,1,0,0,0,0,14,1,0,12,2,19,315,301,14
"N00001098",308,295,1,10,2,19,1,1,0,0,0,0,13,0,1,10,2,19,307,294,13
"N00001099",282,251,1,28,2,26,4,4,0,0,0,0,31,5,1,28,2,31,278,247,31
"N00001100",292,284,0,7,1,8,2,2,0,0,0,0,8,2,0,7,1,10,290,282,8
"N00001101",304,284,0,20,0,15,0,0,0,0,0,0,20,0,0,20,0,15,304,284,20
"N00001102",569,555,2,12,0,17,4,4,0,0,0,0,14,0,2,12,0,17,565,551,14
"N00001103",219,212,0,6,1,17,2,2,0,0,0,0,7,0,0,6,1,17,217,210,7
"N00001104",303,290,0,13,0,29,2,2,0,0,0,0,13,0,0,13,0,29,301,288,13
"N00001105",309,288,0,21,0,17,9,9,0,0,0,0,21,0,0,21,0,17,300,279,21
"N00001106",283,246,0,37,0,27,1,1,0,0,0,0,37,10,0,37,0,37,282,245,37
"N00001107",309,295,0,11,0,27,5,2,3,0,1,2,14,0,0,12,2,27,304,293,11
"N00001108",217,192,1,20,0,22,7,3,4,0,1,3,25,3,1,21,3,25,210,189,21
"N00001109",393,366,4,23,0,29,4,4,0,0,0,0,27,0,4,23,0,29,389,362,27
"N00001110",345,315,2,25,0,22,5,2,3,0,0,3,30,1,2,25,3,23,340,313,27
"N00001111",687,639,2,32,2,36,20,8,12,0,9,3,48,3,2,41,5,39,667,631,36
"N00001112",319,286,0,29,0,14,9,5,4,0,4,0,33,0,0,33,0,14,310,281,29
"N00001113",1384,1203,15,143,11,102,37,25,12,0,9,3,181,4,15,152,14,106,1347,1178,169
"N00001114",319,284,0,24,2,35,25,16,9,0,7,2,35,3,0,31,4,38,294,268,26
"N00001115",222,192,0,27,2,31,3,2,1,0,1,0,30,5,0,28,2,36,219,190,29
"N00001116",497,431,0,56,2,47,25,17,8,0,6,2,66,8,0,62,4,55,472,414,58
"N00001117",728,690,2,34,2,47,1,1,0,0,0,0,38,0,2,34,2,47,727,689,38
"N00001118",305,258,0,46,0,19,8,7,1,0,1,0,47,0,0,47,0,19,297,251,46
"N00001119",176,166,0,10,0,6,1,1,0,0,0,0,10,0,0,10,0,6,175,165,10
"N00001120",213,197,2,14,0,16,0,0,0,0,0,0,16,0,2,14,0,16,213,197,16
"N00001121",235,221,0,14,0,30,1,1,0,0,0,0,14,0,0,14,0,30,234,220,14
"N00001122",176,152,0,24,0,21,0,0,0,0,0,0,24,0,0,24,0,21,176,152,24
"N00001123",186,174,2,9,1,5,0,0,0,0,0,0,12,0,2,9,1,5,186,174,12
"N00001124",568,519,0,48,0,29,7,6,1,0,0,1,49,3,0,48,1,32,561,513,48
"N00001125",413,363,1,48,1,30,1,1,0,0,0,0,50,0,1,48,1,30,412,362,50
"N00001126",242,224,1,12,0,17,7,2,5,0,5,0,18,0,1,17,0,17,235,222,13
"N00001127",639,574,1,58,0,49,10,4,6,0,6,0,65,0,1,64,0,49,629,570,59
"N00001128",251,215,0,35,0,22,1,0,1,0,1,0,36,0,0,36,0,22,250,215,35
"N00001129",450,410,2,31,1,16,7,1,6,0,6,0,40,0,2,37,1,16,443,409,34
"N00001130",179,150,0,14,14,41,2,1,1,0,1,0,29,20,0,15,14,61,177,149,28
"N00001131",1073,700,5,292,26,151,100,50,50,0,33,17,373,26,5,325,43,177,973,650,323
"N00001132",251,239,0,9,2,31,6,5,1,0,1,0,12,2,0,10,2,33,245,234,11
"N00001133",643,569,7,62,2,60,22,19,3,0,3,0,74,1,7,65,2,61,621,550,71
"N00001134",212,186,0,22,3,12,6,5,1,0,0,1,26,0,0,22,4,12,206,181,25
"N00001135",188,162,0,25,0,13,4,3,1,0,0,1,26,0,0,25,1,13,184,159,25
"N00001136",261,226,1,31,0,53,3,0,3,0,1,2,35,5,1,32,2,58,258,226,32
"N00001137",292,268,2,21,0,24,6,5,1,0,1,0,24,0,2,22,0,24,286,263,23
"N00001138",195,164,1,27,0,16,5,2,3,0,3,0,31,0,1,30,0,16,190,162,28
"N00001139",546,494,3,39,5,45,33,28,5,0,4,1,52,3,3,43,6,48,513,466,47
"N00001140",309,265,0,40,4,48,7,7,0,0,0,0,44,1,0,40,4,49,302,258,44
"N00001141",189,160,0,26,1,22,6,4,2,0,2,0,29,0,0,28,1,22,183,156,27
"N00001142",190,173,1,13,0,9,5,2,3,0,3,0,17,0,1,16,0,9,185,171,14
"N00001143",140,135,0,5,0,3,0,0,0,0,0,0,5,0,0,5,0,3,140,135,5
"N00001144",233,205,1,26,0,15,3,2,1,0,1,0,28,0,1,27,0,15,230,203,27
"N00001145",311,282,0,26,3,8,0,0,0,0,0,0,29,2,0,26,3,10,311,282,29
"N00001146",291,282,0,9,0,33,1,1,0,0,0,0,9,0,0,9,0,33,290,281,9
"N00001147",258,225,1,24,2,60,16,10,6,0,4,2,33,10,1,28,4,70,242,215,27
"N00001148",260,250,0,8,1,31,5,4,1,0,0,1,10,0,0,8,2,31,255,246,9
"N00001149",377,358,0,18,0,30,4,3,1,0,0,1,19,0,0,18,1,30,373,355,18
"N00001150",334,314,4,16,0,10,3,3,0,0,0,0,20,0,4,16,0,10,331,311,20
"N00001151",390,353,5,31,0,22,2,1,1,0,1,0,37,0,5,32,0,22,388,352,36
"N00001152",419,374,1,40,0,30,7,3,4,0,4,0,45,0,1,44,0,30,412,371,41
"N00001153",316,300,1,13,0,13,6,4,2,0,0,2,16,0,1,13,2,13,310,296,14
"N00001154",293,276,0,17,0,13,6,6,0,0,0,0,17,0,0,17,0,13,287,270,17
"N00001155",636,460,6,88,16,68,152,86,66,4,24,38,176,30,10,112,54,98,484,374,110
"N00001156",1299,1187,10,96,3,99,3,0,3,0,1,2,112,3,10,97,5,102,1296,1187,109
"N00001157",280,257,0,21,2,18,13,13,0,0,0,0,23,2,0,21,2,20,267,244,23
"N00001158",266,257,0,9,0,10,0,0,0,0,0,0,9,0,0,9,0,10,266,257,9
"N00001159",365,348,0,17,0,15,5,5,0,0,0,0,17,1,0,17,0,16,360,343,17
"N00001160",357,321,0,32,1,8,9,6,3,0,3,0,36,0,0,35,1,8,348,315,33
"N00001161",250,215,0,28,0,22,12,5,7,0,2,5,35,2,0,30,5,24,238,210,28
"N00001162",169,153,0,16,0,19,9,9,0,0,0,0,16,0,0,16,0,19,160,144,16
"N00001163",336,302,0,33,0,7,2,1,1,0,1,0,34,0,0,34,0,7,334,301,33
"N00001164",342,320,0,21,1,25,6,6,0,0,0,0,22,0,0,21,1,25,336,314,22
"N00001165",322,310,1,11,0,24,4,4,0,0,0,0,12,0,1,11,0,24,318,306,12
"N00001166",593,567,0,21,2,45,13,10,3,0,3,0,26,2,0,24,2,47,580,557,23
"N00001167",342,337,0,5,0,39,6,6,0,0,0,0,5,1,0,5,0,40,336,331,5
"N00001168",353,342,1,10,0,19,0,0,0,0,0,0,11,0,1,10,0,19,353,342,11
"N00001169",320,307,0,9,0,16,10,6,4,0,1,3,13,0,0,10,3,16,310,301,9
"N00001170",333,325,2,6,0,28,1,1,0,0,0,0,8,0,2,6,0,28,332,324,8
"N00001171",408,375,0,27,0,26,22,16,6,0,6,0,33,0,0,33,0,26,386,359,27
"N00001172",307,287,2,16,2,21,3,3,0,0,0,0,20,1,2,16,2,22,304,284,20
"N00001173",262,256,0,3,1,11,20,18,2,0,0,2,6,2,0,3,3,13,242,238,4
"N00001174",343,335,0,3,2,15,20,17,3,0,3,0,8,0,0,6,2,15,323,318,5
"N00001175",306,283,0,17,0,24,22,16,6,0,4,2,23,1,0,21,2,25,284,267,17
"N00001176",241,226,0,9,1,15,8,3,5,0,3,2,15,0,0,12,3,15,233,223,10
"N00001177",266,263,0,3,0,11,33,33,0,0,0,0,3,6,0,3,0,17,233,230,3
"N00001178",406,385,0,13,5,18,17,14,3,0,2,1,21,0,0,15,6,18,389,371,18
"N00001179",342,330,0,10,2,20,2,2,0,0,0,0,12,0,0,10,2,20,340,328,12
"N00001180",157,131,0,21,5,11,3,3,0,0,0,0,26,5,0,21,5,16,154,128,26
"N00001181",295,274,0,21,0,14,5,5,0,0,0,0,21,0,0,21,0,14,290,269,21
"N00001182",352,343,0,8,1,25,3,3,0,0,0,0,9,1,0,8,1,26,349,340,9
"N00001183",444,402,0,36,3,40,37,34,3,0,1,2,42,3,0,37,5,43,407,368,39
"N00001184",283,274,0,8,1,4,11,11,0,0,0,0,9,0,0,8,1,4,272,263,9
"N00001185",268,257,0,11,0,6,21,21,0,0,0,0,11,2,0,11,0,8,247,236,11
"N00001186",267,247,0,19,0,15,28,27,1,0,1,0,20,2,0,20,0,17,239,220,19
"N00001187",323,292,1,19,3,19,26,18,8,0,6,2,31,9,1,25,5,28,297,274,23
"N00001188",806,743,1,54,3,29,30,25,5,0,2,3,63,1,1,56,6,30,776,718,58
"N00001189",304,290,0,14,0,16,12,12,0,0,0,0,14,0,0,14,0,16,292,278,14
"N00001190",278,241,1,28,0,25,28,20,8,0,7,1,37,2,1,35,1,27,250,221,29
"N00001191",245,228,0,11,6,26,0,0,0,0,0,0,17,1,0,11,6,27,245,228,17
"N00001192",256,239,0,10,0,17,26,19,7,4,3,0,17,1,4,13,0,18,230,220,10
"N00001193",232,209,2,17,4,35,10,10,0,0,0,0,23,1,2,17,4,36,222,199,23
"N00001194",269,249,0,19,0,11,3,2,1,0,0,1,20,6,0,19,1,17,266,247,19
"N00001195",184,149,1,28,2,26,27,23,4,0,0,4,35,0,1,28,6,26,157,126,31
"N00001196",354,343,0,8,2,15,5,4,1,0,1,0,11,0,0,9,2,15,349,339,10
"N00001197",266,220,8,29,7,40,17,15,2,0,2,0,46,7,8,31,7,47,249,205,44
"N00001198",467,435,0,31,1,54,13,13,0,0,0,0,32,0,0,31,1,54,454,422,32
"N00001199",194,163,0,28,2,29,7,6,1,0,1,0,31,2,0,29,2,31,187,157,30
"N00001200",395,364,2,27,2,18,1,1,0,0,0,0,31,0,2,27,2,18,394,363,31
"N00001201",311,295,0,14,0,22,10,8,2,0,2,0,16,0,0,16,0,22,301,287,14
"N00001202",323,282,0,37,2,16,15,13,2,0,0,2,41,0,0,37,4,16,308,269,39
"N00001203",315,302,0,13,0,14,4,4,0,0,0,0,13,0,0,13,0,14,311,298,13
"N00001204",956,916,1,37,2,37,27,27,0,0,0,0,40,1,1,37,2,38,929,889,40
"N00001205",564,524,0,38,0,47,17,15,2,0,2,0,40,0,0,40,0,47,547,509,38
"N00001206",229,217,0,11,1,10,3,3,0,0,0,0,12,2,0,11,1,12,226,214,12
"N00001207",400,394,0,6,0,20,0,0,0,0,0,0,6,1,0,6,0,21,400,394,6
"N00001208",339,324,0,14,1,27,0,0,0,0,0,0,15,0,0,14,1,27,339,324,15
"N00001209",254,236,0,16,2,20,0,0,0,0,0,0,18,1,0,16,2,21,254,236,18
"N00001210",332,326,0,6,0,18,4,4,0,0,0,0,6,0,0,6,0,18,328,322,6
"N00001211",285,270,0,14,0,11,2,1,1,0,1,0,15,0,0,15,0,11,283,269,14
"N00001212",301,293,0,7,1,22,1,1,0,0,0,0,8,0,0,7,1,22,300,292,8
"N00001213",299,294,0,5,0,8,1,1,0,0,0,0,5,0,0,5,0,8,298,293,5
"N00001214",289,265,0,23,1,23,4,4,0,0,0,0,24,0,0,23,1,23,285,261,24
"N00001215",281,256,0,25,0,7,0,0,0,0,0,0,25,2,0,25,0,9,281,256,25
"N00001216",406,382,1,19,0,26,7,3,4,0,4,0,24,0,1,23,0,26,399,379,20
"N00001217",413,347,0,61,5,16,3,3,0,0,0,0,66,0,0,61,5,16,410,344,66
"N00001218",279,262,0,16,0,9,1,0,1,0,1,0,17,0,0,17,0,9,278,262,16
"N00001219",301,287,0,10,3,23,4,3,1,0,1,0,14,1,0,11,3,24,297,284,13
"N00001220",231,220,0,11,0,14,2,2,0,0,0,0,11,0,0,11,0,14,229,218,11
"N00001221",258,230,0,27,0,12,2,1,1,0,0,1,28,1,0,27,1,13,256,229,27
"N00001222",213,202,0,10,0,25,6,5,1,0,1,0,11,0,0,11,0,25,207,197,10
"N00001223",300,287,1,12,0,14,1,1,0,0,0,0,13,0,1,12,0,14,299,286,13
"N00001224",265,242,0,23,0,30,2,2,0,0,0,0,23,7,0,23,0,37,263,240,23
"N00001225",242,230,0,12,0,13,3,3,0,0,0,0,12,0,0,12,0,13,239,227,12
"N00001226",236,204,0,28,2,31,3,1,2,0,1,1,32,0,0,29,3,31,233,203,30
"N00001227",246,242,0,3,1,9,0,0,0,0,0,0,4,0,0,3,1,9,246,242,4
"N00001228",212,180,0,32,0,12,1,1,0,0,0,0,32,0,0,32,0,12,211,179,32
"N00001229",255,248,0,7,0,9,1,1,0,0,0,0,7,0,0,7,0,9,254,247,7
"N00001230",298,285,0,13,0,19,7,7,0,0,0,0,13,1,0,13,0,20,291,278,13
"N00001231",401,381,1,18,0,22,3,2,1,0,1,0,20,1,1,19,0,23,398,379,19
"N00001232",375,364,0,10,1,17,0,0,0,0,0,0,11,0,0,10,1,17,375,364,11
"N00001233",421,408,0,10,1,8,5,3,2,0,2,0,13,0,0,12,1,8,416,405,11
"N00001234",351,333,1,16,1,24,6,6,0,0,0,0,18,1,1,16,1,25,345,327,18
"N00001235",953,914,4,33,2,48,4,4,0,0,0,0,39,0,4,33,2,48,949,910,39
"N00001236",372,365,0,7,0,41,5,5,0,0,0,0,7,0,0,7,0,41,367,360,7
"N00001237",289,269,1,18,1,26,1,1,0,0,0,0,20,0,1,18,1,26,288,268,20
"N00001238",297,278,0,15,0,15,6,2,4,0,4,0,19,0,0,19,0,15,291,276,15
"N00001239",313,307,0,6,0,7,0,0,0,0,0,0,6,0,0,6,0,7,313,307,6
"N00001240",1095,1009,5,80,1,82,7,7,0,0,0,0,86,3,5,80,1,85,1088,1002,86
"N00001241",352,335,0,15,2,9,2,2,0,0,0,0,17,0,0,15,2,9,350,333,17
"N00001242",335,316,0,19,0,24,1,1,0,0,0,0,19,0,0,19,0,24,334,315,19
"N00001243",275,265,0,9,1,23,0,0,0,0,0,0,10,0,0,9,1,23,275,265,10
"N00001244",335,308,0,25,1,19,1,0,1,0,1,0,27,0,0,26,1,19,334,308,26
"N00001245",334,315,0,19,0,26,3,3,0,0,0,0,19,0,0,19,0,26,331,312,19
"N00001246",608,533,0,70,2,38,14,11,3,0,3,0,75,0,0,73,2,38,594,522,72
"N00001247",245,232,0,9,4,13,6,6,0,0,0,0,13,0,0,9,4,13,239,226,13
"N00001248",430,419,2,7,1,35,1,0,1,0,1,0,11,3,2,8,1,38,429,419,10
"N00001249",403,393,1,7,2,17,4,4,0,0,0,0,10,0,1,7,2,17,399,389,10
"N00001250",463,451,0,12,0,16,5,5,0,0,0,0,12,0,0,12,0,16,458,446,12
"N00001251",327,310,0,16,0,13,22,21,1,0,1,0,17,1,0,17,0,14,305,289,16
"N00001252",321,296,0,18,2,17,18,13,5,0,4,1,25,3,0,22,3,20,303,283,20
"N00001253",233,220,3,8,0,16,13,11,2,0,2,0,13,1,3,10,0,17,220,209,11
"N00001254",314,301,0,13,0,20,1,1,0,0,0,0,13,0,0,13,0,20,313,300,13
"N00001255",276,269,1,4,2,9,3,3,0,0,0,0,7,0,1,4,2,9,273,266,7
"N00001256",262,247,0,15,0,16,1,1,0,0,0,0,15,0,0,15,0,16,261,246,15
"N00001257",233,210,0,20,1,9,3,1,2,0,1,1,23,0,0,21,2,9,230,209,21
"N00001258",250,227,6,16,1,17,5,5,0,0,0,0,23,1,6,16,1,18,245,222,23
"N00001259",285,270,0,14,0,8,11,10,1,0,1,0,15,0,0,15,0,8,274,260,14
"N00001260",363,326,4,26,0,10,9,2,7,0,7,0,37,0,4,33,0,10,354,324,30
"N00001261",249,236,0,13,0,15,1,1,0,0,0,0,13,1,0,13,0,16,248,235,13
"N00001262",389,377,1,11,0,36,2,2,0,0,0,0,12,0,1,11,0,36,387,375,12
"N00001263",289,240,0,44,2,22,7,4,3,0,3,0,49,0,0,47,2,22,282,236,46
"N00001264",204,180,2,22,0,10,2,2,0,0,0,0,24,1,2,22,0,11,202,178,24
"N00001265",971,647,1,203,21,101,172,73,99,10,38,51,324,34,11,241,72,135,799,574,225
"N00001266",188,170,2,16,0,14,0,0,0,0,0,0,18,0,2,16,0,14,188,170,18
"N00001267",322,286,4,30,0,20,7,5,2,0,1,1,36,0,4,31,1,20,315,281,34
"N00001268",283,255,0,25,3,20,0,0,0,0,0,0,28,0,0,25,3,20,283,255,28
"N00001269",522,428,0,78,8,84,40,32,8,0,8,0,94,10,0,86,8,94,482,396,86
"N00001270",278,228,4,42,2,20,10,8,2,0,2,0,50,0,4,44,2,20,268,220,48
"N00001271",1514,1253,6,218,15,239,88,66,22,0,15,7,261,19,6,233,22,258,1426,1187,239
"N00001272",222,197,0,18,1,24,18,12,6,0,6,0,25,0,0,24,1,24,204,185,19
"N00001273",221,185,0,33,2,24,6,5,1,0,1,0,36,3,0,34,2,27,215,180,35
"N00001274",238,222,0,15,0,9,1,0,1,0,1,0,16,0,0,16,0,9,237,222,15
"N00001275",210,197,0,13,0,18,0,0,0,0,0,0,13,2,0,13,0,20,210,197,13
"N00001276",218,208,0,10,0,18,1,1,0,0,0,0,10,1,0,10,0,19,217,207,10
"N00001277",266,254,0,11,1,19,9,9,0,0,0,0,12,0,0,11,1,19,257,245,12
"N00001278",291,271,0,19,0,18,7,6,1,0,1,0,20,0,0,20,0,18,284,265,19
"N00001279",168,152,0,12,0,19,5,1,4,0,4,0,16,0,0,16,0,19,163,151,12
"N00001280",213,197,1,14,1,31,3,3,0,0,0,0,16,0,1,14,1,31,210,194,16
"N00001281",334,303,0,26,5,25,5,5,0,0,0,0,31,0,0,26,5,25,329,298,31
"N00001282",330,308,0,19,3,23,10,10,0,0,0,0,22,0,0,19,3,23,320,298,22
"N00001283",338,314,0,24,0,18,5,5,0,0,0,0,24,0,0,24,0,18,333,309,24
"N00001284",352,338,0,14,0,24,11,11,0,0,0,0,14,0,0,14,0,24,341,327,14
"N00001285",331,323,0,8,0,10,4,4,0,0,0,0,8,0,0,8,0,10,327,319,8
"N00001286",348,324,0,23,1,31,0,0,0,0,0,0,24,0,0,23,1,31,348,324,24
"N00001287",295,271,0,24,0,8,2,2,0,0,0,0,24,0,0,24,0,8,293,269,24
"N00001288",289,281,0,8,0,14,1,1,0,0,0,0,8,0,0,8,0,14,288,280,8
"N00001289",288,282,0,6,0,17,3,3,0,0,0,0,6,0,0,6,0,17,285,279,6
"N00001290",318,310,0,8,0,8,6,6,0,0,0,0,8,0,0,8,0,8,312,304,8
"N00001291",344,329,3,12,0,16,6,6,0,0,0,0,15,0,3,12,0,16,338,323,15
"N00001292",878,822,1,54,0,42,10,9,1,0,1,0,56,6,1,55,0,48,868,813,55
"N00001293",358,350,0,8,0,15,0,0,0,0,0,0,8,0,0,8,0,15,358,350,8
"N00001294",335,326,0,9,0,18,3,3,0,0,0,0,9,0,0,9,0,18,332,323,9
"N00001295",312,303,0,9,0,14,1,1,0,0,0,0,9,1,0,9,0,15,311,302,9
"N00001296",273,259,3,10,1,22,1,1,0,0,0,0,14,0,3,10,1,22,272,258,14
"N00001297",384,361,0,19,0,31,7,3,4,0,1,3,23,0,0,20,3,31,377,358,19
"N00001298",394,338,7,40,1,14,19,11,8,0,0,8,56,1,7,40,9,15,375,327,48
"N00001299",319,303,0,14,2,25,1,1,0,0,0,0,16,2,0,14,2,27,318,302,16
"N00001300",287,279,0,8,0,26,0,0,0,0,0,0,8,0,0,8,0,26,287,279,8
"N00001301",375,373,0,1,1,13,5,5,0,0,0,0,2,0,0,1,1,13,370,368,2
"N00001302",745,696,2,45,2,36,4,4,0,0,0,0,49,0,2,45,2,36,741,692,49
"N00001303",333,312,0,20,0,34,6,5,1,0,1,0,21,0,0,21,0,34,327,307,20
"N00001304",322,304,0,17,1,10,0,0,0,0,0,0,18,0,0,17,1,10,322,304,18
"N00001305",325,323,0,1,1,8,2,2,0,0,0,0,2,0,0,1,1,8,323,321,2
"N00001306",214,175,0,37,1,17,4,3,1,0,1,0,39,0,0,38,1,17,210,172,38
"N00001307",321,301,0,20,0,29,0,0,0,0,0,0,20,0,0,20,0,29,321,301,20
"N00001308",486,455,0,25,1,14,25,20,5,0,4,1,31,0,0,29,2,14,461,435,26
"N00001309",368,319,1,43,0,29,17,12,5,0,5,0,49,0,1,48,0,29,351,307,44
"N00001310",981,944,2,32,1,45,38,36,2,0,2,0,37,0,2,34,1,45,943,908,35
"N00001311",326,302,2,15,0,13,17,10,7,0,7,0,24,0,2,22,0,13,309,292,17
"N00001312",654,591,5,53,2,33,29,26,3,0,1,2,63,4,5,54,4,37,625,565,60
"N00001313",417,330,1,65,5,24,62,46,16,0,14,2,87,2,1,79,7,26,355,284,71
"N00001314",401,378,0,21,0,15,43,41,2,0,2,0,23,4,0,23,0,19,358,337,21
"N00001315",246,229,0,17,0,25,3,3,0,0,0,0,17,0,0,17,0,25,243,226,17
"N00001316",352,297,13,33,9,36,12,12,0,0,0,0,55,7,13,33,9,43,340,285,55
"N00001317",267,259,0,8,0,28,6,6,0,0,0,0,8,1,0,8,0,29,261,253,8
"N00001318",287,257,0,24,1,29,14,9,5,0,4,1,30,2,0,28,2,31,273,248,25
"N00001319",285,262,0,17,6,14,4,4,0,0,0,0,23,0,0,17,6,14,281,258,23
"N00001320",253,249,0,4,0,11,1,1,0,0,0,0,4,0,0,4,0,11,252,248,4
"N00001321",274,259,0,15,0,8,4,4,0,0,0,0,15,0,0,15,0,8,270,255,15
"N00001322",274,251,1,21,0,21,4,3,1,1,0,0,23,0,2,21,0,21,270,248,22
"N00001323",295,278,0,11,5,27,4,3,1,0,1,0,17,0,0,12,5,27,291,275,16
"N00001324",243,230,0,8,3,25,10,8,2,0,0,2,13,0,0,8,5,25,233,222,11
"N00001325",1263,1110,1,121,12,141,52,33,19,0,17,2,153,7,1,138,14,148,1211,1077,134
"N00001326",360,334,0,16,2,27,15,7,8,0,8,0,26,0,0,24,2,27,345,327,18
"N00001327",328,309,0,9,3,18,11,4,7,0,7,0,19,0,0,16,3,18,317,305,12
"N00001328",1036,904,5,104,11,100,56,44,12,0,9,3,132,4,5,113,14,104,980,860,120
"N00001329",281,259,0,21,1,34,9,9,0,0,0,0,22,0,0,21,1,34,272,250,22
"N00001330",322,286,6,29,0,22,6,5,1,0,1,0,36,1,6,30,0,23,316,281,35
"N00001331",274,243,0,29,2,32,2,2,0,0,0,0,31,0,0,29,2,32,272,241,31
"N00001332",186,127,0,52,2,32,11,6,5,0,5,0,59,3,0,57,2,35,175,121,54
"N00001333",337,293,0,41,1,40,14,12,2,0,2,0,44,2,0,43,1,42,323,281,42
"N00001334",354,293,0,47,7,27,38,31,7,0,3,4,61,1,0,50,11,28,316,262,54
"N00001335",194,148,1,40,4,68,12,11,1,0,0,1,46,1,1,40,5,69,182,137,45
"N00001336",318,301,0,10,4,29,12,9,3,0,1,2,17,0,0,11,6,29,306,292,14
"N00001337",302,271,0,25,2,31,15,11,4,0,4,0,31,6,0,29,2,37,287,260,27
"N00001338",303,270,0,28,1,35,31,27,4,0,4,0,33,3,0,32,1,38,272,243,29
"N00001339",370,358,0,5,0,28,46,39,7,1,5,1,12,0,1,10,1,28,324,319,5
"N00001340",779,699,0,70,4,58,78,72,6,0,4,2,80,29,0,74,6,87,701,627,74
"N00001341",329,316,0,12,0,9,1,0,1,0,1,0,13,0,0,13,0,9,328,316,12
"N00001342",388,380,0,6,2,27,0,0,0,0,0,0,8,0,0,6,2,27,388,380,8
"N00001343",293,280,0,12,1,13,4,4,0,0,0,0,13,0,0,12,1,13,289,276,13
"N00001344",330,321,0,8,0,23,2,1,1,0,1,0,9,0,0,9,0,23,328,320,8
"N00001345",250,236,0,14,0,18,1,1,0,0,0,0,14,4,0,14,0,22,249,235,14
"N00001346",820,721,1,87,3,86,41,33,8,0,7,1,99,2,1,94,4,88,779,688,91
"N00001347",513,417,0,88,5,74,10,7,3,0,1,2,96,4,0,89,7,78,503,410,93
"N00001348",304,286,0,17,1,23,11,11,0,0,0,0,18,1,0,17,1,24,293,275,18
"N00001349",248,218,0,26,3,27,14,13,1,0,1,0,30,6,0,27,3,33,234,205,29
"N00001350",919,842,4,72,1,61,15,15,0,0,0,0,77,9,4,72,1,70,904,827,77
"N00001351",390,339,0,47,1,31,4,1,3,0,3,0,51,0,0,50,1,31,386,338,48
"N00001352",303,261,4,29,5,43,11,7,4,0,2,2,42,0,4,31,7,43,292,254,38
"N00001353",358,314,7,34,1,18,4,2,2,0,2,0,44,1,7,36,1,19,354,312,42
"N00001354",756,704,4,41,1,51,20,14,6,0,4,2,52,1,4,45,3,52,736,690,46
"N00001355",287,268,0,16,1,19,6,4,2,0,1,1,19,2,0,17,2,21,281,264,17
"N00001356",280,267,4,8,0,22,4,3,1,0,1,0,13,0,4,9,0,22,276,264,12
"N00001357",155,139,0,16,0,20,0,0,0,0,0,0,16,1,0,16,0,21,155,139,16
"N00001358",344,310,0,30,1,29,5,2,3,0,0,3,34,0,0,30,4,29,339,308,31
"N00001359",294,267,0,23,3,36,4,3,1,0,1,0,27,16,0,24,3,52,290,264,26
"N00001360",276,262,2,6,2,32,15,11,4,0,4,0,14,0,2,10,2,32,261,251,10
"N00001361",295,275,0,20,0,34,10,10,0,0,0,0,20,0,0,20,0,34,285,265,20
"N00001362",293,271,0,22,0,11,0,0,0,0,0,0,22,0,0,22,0,11,293,271,22
"N00001363",263,242,0,21,0,23,1,1,0,0,0,0,21,0,0,21,0,23,262,241,21
"N00001364",539,475,2,53,6,39,21,18,3,0,1,2,64,2,2,54,8,41,518,457,61
"N00001365",387,343,0,43,1,46,5,5,0,0,0,0,44,1,0,43,1,47,382,338,44
"N00001366",252,215,0,31,4,42,6,4,2,0,0,2,37,0,0,31,6,42,246,211,35
"N00001367",353,310,0,38,2,33,4,1,3,0,3,0,43,2,0,41,2,35,349,309,40
"N00001368",295,265,0,24,5,19,1,0,1,0,1,0,30,5,0,25,5,24,294,265,29
"N00001369",365,317,0,44,1,18,8,5,3,0,3,0,48,1,0,47,1,19,357,312,45
"N00001370",369,340,0,28,1,25,1,1,0,0,0,0,29,3,0,28,1,28,368,339,29
"N00001371",313,302,0,11,0,28,1,1,0,0,0,0,11,0,0,11,0,28,312,301,11
"N00001372",584,552,0,31,1,25,12,12,0,0,0,0,32,1,0,31,1,26,572,540,32
"N00001373",293,277,0,14,1,20,2,1,1,0,1,0,16,0,0,15,1,20,291,276,15
"N00001374",297,288,0,9,0,23,4,4,0,0,0,0,9,0,0,9,0,23,293,284,9
"N00001375",338,316,0,16,5,20,7,6,1,0,0,1,22,3,0,16,6,23,331,310,21
"N00001376",191,173,0,18,0,22,9,9,0,0,0,0,18,0,0,18,0,22,182,164,18
"N00001377",276,262,0,14,0,19,0,0,0,0,0,0,14,0,0,14,0,19,276,262,14
"N00001378",258,241,0,16,0,22,2,1,1,0,1,0,17,0,0,17,0,22,256,240,16
"N00001379",246,231,0,15,0,8,0,0,0,0,0,0,15,0,0,15,0,8,246,231,15
"N00001380",381,338,0,33,5,36,10,5,5,0,5,0,43,5,0,38,5,41,371,333,38
"N00001381",395,308,0,71,8,68,18,10,8,0,6,2,87,0,0,77,10,68,377,298,79
"N00001382",316,291,0,23,2,36,6,6,0,0,0,0,25,1,0,23,2,37,310,285,25
"N00001383",344,325,0,16,3,10,1,1,0,0,0,0,19,0,0,16,3,10,343,324,19
"N00001384",287,265,0,22,0,20,6,6,0,0,0,0,22,4,0,22,0,24,281,259,22
"N00001385",359,334,0,16,8,64,8,7,1,0,0,1,25,2,0,16,9,66,351,327,24
"N00001386",532,407,0,109,7,99,12,3,9,0,8,1,125,2,0,117,8,101,520,404,116
"N00001387",263,219,0,31,9,33,13,9,4,0,0,4,44,0,0,31,13,33,250,210,40
"N00001388",270,236,0,32,1,14,8,7,1,0,1,0,34,1,0,33,1,15,262,229,33
"N00001389",188,160,0,26,0,43,7,5,2,0,2,0,28,1,0,28,0,44,181,155,26
"N00001390",287,269,0,17,1,23,0,0,0,0,0,0,18,0,0,17,1,23,287,269,18
"N00001391",286,267,0,11,6,34,11,9,2,0,2,0,19,0,0,13,6,34,275,258,17
"N00001392",263,199,2,58,3,71,8,7,1,0,1,0,64,4,2,59,3,75,255,192,63
"N00001393",269,199,2,60,8,35,3,3,0,0,0,0,70,6,2,60,8,41,266,196,70
"N00001394",284,249,0,28,6,27,5,4,1,0,1,0,35,1,0,29,6,28,279,245,34
"N00001395",277,243,0,27,6,34,4,3,1,0,1,0,34,2,0,28,6,36,273,240,33
"N00001396",607,404,3,174,17,113,20,11,9,0,8,1,203,8,3,182,18,121,587,393,194
"N00001397",183,150,0,29,2,30,5,3,2,0,2,0,33,0,0,31,2,30,178,147,31
"N00001398",250,218,0,25,3,22,4,0,4,0,4,0,32,3,0,29,3,25,246,218,28
"N00001399",889,812,0,67,8,91,19,17,2,0,2,0,77,3,0,69,8,94,870,795,75
"N00001400",330,302,0,26,2,23,5,5,0,0,0,0,28,0,0,26,2,23,325,297,28
"N00001401",851,602,5,213,12,104,71,52,19,0,16,3,249,20,5,229,15,124,780,550,230
"N00001402",652,544,1,93,7,75,25,18,7,0,7,0,108,13,1,100,7,88,627,526,101
"N00001403",377,314,0,48,7,27,19,11,8,0,5,3,63,1,0,53,10,28,358,303,55
"N00001404",706,534,9,117,15,126,37,6,31,0,24,7,172,11,9,141,22,137,669,528,141
"N00001405",235,206,0,28,0,30,2,1,1,0,1,0,29,0,0,29,0,30,233,205,28
"N00001406",216,201,0,13,2,18,3,3,0,0,0,0,15,0,0,13,2,18,213,198,15
"N00001407",256,197,0,48,10,24,6,5,1,0,0,1,59,1,0,48,11,25,250,192,58
"N00001408",467,416,0,48,2,62,7,6,1,0,1,0,51,1,0,49,2,63,460,410,50
"N00001409",292,256,0,30,4,28,9,7,2,0,0,2,36,0,0,30,6,28,283,249,34
"N00001410",294,284,0,8,2,28,8,8,0,0,0,0,10,1,0,8,2,29,286,276,10
"N00001411",280,236,0,40,1,36,6,3,3,0,2,1,44,0,0,42,2,36,274,233,41
"N00001412",164,143,0,20,0,15,6,5,1,0,1,0,21,0,0,21,0,15,158,138,20
"N00001413",277,253,0,24,0,11,6,6,0,0,0,0,24,0,0,24,0,11,271,247,24
"N00001414",278,245,1,28,3,22,5,4,1,0,1,0,33,0,1,29,3,22,273,241,32
"N00001415",275,264,0,7,3,9,3,2,1,0,1,0,11,1,0,8,3,10,272,262,10
"N00001416",947,663,0,117,21,157,303,157,146,2,68,76,284,79,2,185,97,236,644,506,138
"N00001417",277,238,1,32,1,18,6,1,5,0,5,0,39,1,1,37,1,19,271,237,34
"N00001418",662,536,9,72,9,86,67,31,36,0,21,15,126,16,9,93,24,102,595,505,90
"N00001419",248,193,1,44,3,33,13,6,7,0,3,4,55,11,1,47,7,44,235,187,48
"N00001420",243,212,0,17,1,28,32,19,13,3,6,4,31,14,3,23,5,42,211,193,18
"N00001421",1333,941,8,291,20,188,182,109,73,8,44,21,392,26,16,335,41,214,1151,832,319
"N00001422",200,184,0,11,2,8,29,26,3,0,3,0,16,3,0,14,2,11,171,158,13
"N00001423",445,423,0,19,1,20,54,52,2,0,1,1,22,0,0,20,2,20,391,371,20
"N00001424",223,191,0,28,1,29,21,18,3,0,3,0,32,1,0,31,1,30,202,173,29
"N00001425",267,234,0,25,3,23,33,28,5,0,3,2,33,5,0,28,5,28,234,206,28
"N00001426",229,206,0,16,4,20,8,5,3,0,3,0,23,0,0,19,4,20,221,201,20
"N00001427",251,229,1,21,0,23,0,0,0,0,0,0,22,1,1,21,0,24,251,229,22
"N00001428",279,211,0,66,1,43,2,1,1,0,1,0,68,3,0,67,1,46,277,210,67
"N00001429",1073,749,5,232,24,136,136,73,63,0,32,31,324,47,5,264,55,183,937,676,261
"N00001430",262,224,1,33,0,18,4,0,4,0,1,3,38,2,1,34,3,20,258,224,34
"N00001431",326,301,1,24,0,29,0,0,0,0,0,0,25,0,1,24,0,29,326,301,25
"N00001432",281,256,2,23,0,39,0,0,0,0,0,0,25,0,2,23,0,39,281,256,25
"N00001433",254,229,0,25,0,17,7,7,0,0,0,0,25,0,0,25,0,17,247,222,25
"N00001434",302,284,2,15,0,15,1,0,1,0,1,0,18,0,2,16,0,15,301,284,17
"N00001435",233,214,2,17,0,30,0,0,0,0,0,0,19,0,2,17,0,30,233,214,19
"N00001436",301,274,0,26,0,6,3,2,1,0,1,0,27,0,0,27,0,6,298,272,26
"N00001437",201,188,0,13,0,15,0,0,0,0,0,0,13,0,0,13,0,15,201,188,13
"N00001438",291,267,4,15,1,12,8,4,4,0,2,2,24,0,4,17,3,12,283,263,20
"N00001439",270,208,6,47,2,18,21,14,7,0,6,1,62,2,6,53,3,20,249,194,55
"N00001440",251,238,0,13,0,9,5,5,0,0,0,0,13,0,0,13,0,9,246,233,13
"N00001441",282,255,3,23,0,22,16,15,1,0,1,0,27,0,3,24,0,22,266,240,26
"N00001442",347,306,0,40,1,26,3,3,0,0,0,0,41,0,0,40,1,26,344,303,41
"N00001443",209,185,0,23,1,23,2,2,0,0,0,0,24,2,0,23,1,25,207,183,24
"N00001444",268,229,4,35,0,32,0,0,0,0,0,0,39,3,4,35,0,35,268,229,39
"N00001445",371,345,0,26,0,21,3,3,0,0,0,0,26,0,0,26,0,21,368,342,26
"N00001446",304,291,0,13,0,22,0,0,0,0,0,0,13,1,0,13,0,23,304,291,13
"N00001447",315,279,0,33,1,17,9,7,2,0,2,0,36,0,0,35,1,17,306,272,34
"N00001448",350,346,0,3,1,22,0,0,0,0,0,0,4,2,0,3,1,24,350,346,4
"N00001449",323,299,3,18,2,17,6,5,1,0,0,1,24,0,3,18,3,17,317,294,23
"N00001450",263,253,0,9,1,19,3,3,0,0,0,0,10,0,0,9,1,19,260,250,10
"N00001451",248,221,0,19,1,22,9,2,7,0,7,0,27,0,0,26,1,22,239,219,20
"N00001452",324,309,0,14,0,9,1,0,1,0,1,0,15,0,0,15,0,9,323,309,14
"N00001453",372,357,0,14,1,21,4,4,0,0,0,0,15,0,0,14,1,21,368,353,15
"N00001454",319,301,0,14,3,22,3,2,1,0,1,0,18,1,0,15,3,23,316,299,17
"N00001455",261,241,0,18,2,18,0,0,0,0,0,0,20,0,0,18,2,18,261,241,20
"N00001456",334,301,1,32,0,28,3,3,0,0,0,0,33,0,1,32,0,28,331,298,33
"N00001457",318,306,0,12,0,22,5,5,0,0,0,0,12,2,0,12,0,24,313,301,12
"N00001458",376,331,3,42,0,27,6,6,0,0,0,0,45,1,3,42,0,28,370,325,45
"N00001459",471,392,0,54,4,23,59,38,21,0,7,14,79,5,0,61,18,28,412,354,58
"N00001460",599,547,0,47,3,76,12,10,2,0,2,0,52,1,0,49,3,77,587,537,50
"N00001461",317,283,0,32,0,32,10,8,2,0,1,1,34,1,0,33,1,33,307,275,32
"N00001462",357,325,0,26,3,26,14,11,3,0,1,2,32,0,0,27,5,26,343,314,29
"N00001463",385,347,0,34,4,46,5,5,0,0,0,0,38,1,0,34,4,47,380,342,38
"N00001464",345,322,1,13,2,25,40,33,7,2,1,4,23,5,3,14,6,30,305,289,16
"N00001465",422,396,0,26,0,36,15,15,0,0,0,0,26,0,0,26,0,36,407,381,26
"N00001466",280,185,0,77,9,40,21,12,9,0,5,4,95,11,0,82,13,51,259,173,86
"N00001467",1504,332,18,959,92,909,143,40,103,0,34,69,1172,60,18,993,161,969,1361,292,1069
"N00001468",283,127,3,138,5,105,18,8,10,0,7,3,156,3,3,145,8,108,265,119,146
"N00001469",246,129,0,105,1,66,16,5,11,0,11,0,117,13,0,116,1,79,230,124,106
"N00001470",348,125,6,198,13,118,16,10,6,0,2,4,223,7,6,200,17,125,332,115,217
"N00001471",493,136,7,327,15,146,13,5,8,0,8,0,357,10,7,335,15,156,480,131,349
"N00001472",891,598,0,274,12,168,29,22,7,0,7,0,293,2,0,281,12,170,862,576,286
"N00001473",426,273,1,129,11,77,36,24,12,0,11,1,153,11,1,140,12,88,390,249,141
"N00001474",347,290,0,46,10,25,10,9,1,0,0,1,57,0,0,46,11,25,337,281,56
"N00001475",302,217,0,75,1,56,17,8,9,0,7,2,85,1,0,82,3,57,285,209,76
"N00001476",277,216,0,48,8,19,23,18,5,0,4,1,61,0,0,52,9,19,254,198,56
"N00001477",271,229,0,32,1,33,19,10,9,0,3,6,42,4,0,35,7,37,252,219,33
"N00001478",301,251,0,45,4,26,26,25,1,0,1,0,50,6,0,46,4,32,275,226,49
"N00001479",344,297,0,42,2,40,20,17,3,0,1,2,47,0,0,43,4,40,324,280,44
"N00001480",477,417,4,51,1,38,7,3,4,0,1,3,60,5,4,52,4,43,470,414,56
"N00001481",229,212,0,13,2,28,8,6,2,0,1,1,17,0,0,14,3,28,221,206,15
"N00001482",307,257,0,43,1,30,16,10,6,0,6,0,50,1,0,49,1,31,291,247,44
"N00001483",254,236,0,15,0,29,14,11,3,0,3,0,18,2,0,18,0,31,240,225,15
"N00001484",213,191,0,20,2,15,4,4,0,0,0,0,22,2,0,20,2,17,209,187,22
"N00001485",248,215,0,26,3,28,10,6,4,0,4,0,33,0,0,30,3,28,238,209,29
"N00001486",358,331,0,25,1,28,25,24,1,0,1,0,27,0,0,26,1,28,333,307,26
"N00001487",298,268,6,22,2,16,0,0,0,0,0,0,30,0,6,22,2,16,298,268,30
"N00001488",277,245,0,21,6,19,9,4,5,0,4,1,32,0,0,25,7,19,268,241,27
"N00001489",293,272,0,20,0,32,6,5,1,0,1,0,21,0,0,21,0,32,287,267,20
"N00001490",196,174,0,17,1,24,5,1,4,0,1,3,22,0,0,18,4,24,191,173,18
"N00001491",250,223,0,26,1,22,2,2,0,0,0,0,27,0,0,26,1,22,248,221,27
"N00001492",226,201,1,22,2,20,4,4,0,0,0,0,25,1,1,22,2,21,222,197,25
"N00001493",260,233,0,27,0,20,3,3,0,0,0,0,27,0,0,27,0,20,257,230,27
"N00001494",198,162,0,34,2,17,7,7,0,0,0,0,36,0,0,34,2,17,191,155,36
"N00001495",288,259,0,29,0,34,10,10,0,0,0,0,29,0,0,29,0,34,278,249,29
"N00001496",266,228,3,30,2,22,12,9,3,0,1,2,38,0,3,31,4,22,254,219,35
"N00001497",236,198,0,32,4,21,14,12,2,0,1,1,38,5,0,33,5,26,222,186,36
"N00001498",460,399,2,48,6,37,10,5,5,0,5,0,61,0,2,53,6,37,450,394,56
"N00001499",335,282,0,39,4,25,21,11,10,0,10,0,53,3,0,49,4,28,314,271,43
"N00001500",214,179,0,27,2,31,22,16,6,0,5,1,35,0,0,32,3,31,192,163,29
"N00001501",497,419,7,68,2,52,11,10,1,0,1,0,78,0,7,69,2,52,486,409,77
"N00001502",409,352,1,45,6,29,7,2,5,0,5,0,57,2,1,50,6,31,402,350,52
"N00001503",204,185,0,17,1,34,6,5,1,0,1,0,19,0,0,18,1,34,198,180,18
"N00001504",272,237,0,30,3,19,9,7,2,0,2,0,35,1,0,32,3,20,263,230,33
"N00001505",473,377,5,73,16,72,13,11,2,0,2,0,96,15,5,75,16,87,460,366,94
"N00001506",239,189,1,38,9,58,13,11,2,0,2,0,50,0,1,40,9,58,226,178,48
"N00001507",254,226,0,24,0,22,7,3,4,0,4,0,28,0,0,28,0,22,247,223,24
"N00001508",466,392,0,62,8,52,24,20,4,0,3,1,74,6,0,65,9,58,442,372,70
"N00001509",385,340,0,38,1,28,21,15,6,0,2,4,45,4,0,40,5,32,364,325,39
"N00001510",215,182,0,25,5,33,8,5,3,0,0,3,33,2,0,25,8,35,207,177,30
"N00001511",638,538,0,90,6,42,14,10,4,0,4,0,100,1,0,94,6,43,624,528,96
"N00001512",294,212,2,64,11,44,9,4,5,0,3,2,82,5,2,67,13,49,285,208,77
"N00001513",236,182,5,45,3,25,5,4,1,0,1,0,54,0,5,46,3,25,231,178,53
"N00001514",249,223,0,23,3,46,22,22,0,0,0,0,26,2,0,23,3,48,227,201,26
"N00001515",351,327,0,16,5,43,14,11,3,0,2,1,24,16,0,18,6,59,337,316,21
"N00001516",275,264,0,11,0,20,4,4,0,0,0,0,11,0,0,11,0,20,271,260,11
"N00001517",359,334,0,17,7,46,10,9,1,0,0,1,25,4,0,17,8,50,349,325,24
"N00001518",436,392,0,40,1,39,46,43,3,0,2,1,44,5,0,42,2,44,390,349,41
"N00001519",298,266,1,26,4,26,14,13,1,0,1,0,32,0,1,27,4,26,284,253,31
"N00001520",265,249,1,12,0,16,6,3,3,0,0,3,16,2,1,12,3,18,259,246,13
"N00001521",249,219,5,24,1,7,4,4,0,0,0,0,30,0,5,24,1,7,245,215,30
"N00001522",278,256,0,21,1,22,0,0,0,0,0,0,22,0,0,21,1,22,278,256,22
"N00001523",211,189,3,17,1,16,5,4,1,0,1,0,22,0,3,18,1,16,206,185,21
"N00001524",253,224,0,23,1,10,13,8,5,0,3,2,29,0,0,26,3,10,240,216,24
"N00001525",239,219,0,15,0,11,18,13,5,0,3,2,20,0,0,18,2,11,221,206,15
"N00001526",219,196,2,17,0,15,7,3,4,0,4,0,23,1,2,21,0,16,212,193,19
"N00001527",243,213,0,26,3,22,14,13,1,0,1,0,30,0,0,27,3,22,229,200,29
"N00001528",244,211,1,17,1,31,27,13,14,0,10,4,33,5,1,27,5,36,217,198,19
"N00001529",286,265,0,14,3,13,17,13,4,0,0,4,21,0,0,14,7,13,269,252,17
"N00001530",386,359,0,22,2,29,15,12,3,0,3,0,27,1,0,25,2,30,371,347,24
"N00001531",320,297,0,22,0,5,7,6,1,0,1,0,23,0,0,23,0,5,313,291,22
"N00001532",435,407,3,25,0,24,13,13,0,0,0,0,28,0,3,25,0,24,422,394,28
"N00001533",636,593,5,34,3,23,13,12,1,0,1,0,43,0,5,35,3,23,623,581,42
"N00001534",321,304,0,14,0,23,6,3,3,0,3,0,17,3,0,17,0,26,315,301,14
"N00001535",385,326,0,53,0,31,10,4,6,0,6,0,59,2,0,59,0,33,375,322,53
"N00001536",401,380,0,18,3,31,1,1,0,0,0,0,21,0,0,18,3,31,400,379,21
"N00001537",356,350,0,6,0,26,1,1,0,0,0,0,6,0,0,6,0,26,355,349,6
"N00001538",386,377,1,8,0,20,0,0,0,0,0,0,9,0,1,8,0,20,386,377,9
"N00001539",346,333,0,10,2,15,1,0,1,0,1,0,13,0,0,11,2,15,345,333,12
"N00001540",408,389,0,15,0,23,9,5,4,0,0,4,19,0,0,15,4,23,399,384,15
"N00001541",286,264,0,14,8,4,1,1,0,0,0,0,22,0,0,14,8,4,285,263,22
"N00001542",324,315,0,8,0,11,4,3,1,0,1,0,9,0,0,9,0,11,320,312,8
"N00001543",366,356,0,9,0,12,4,3,1,0,0,1,10,0,0,9,1,12,362,353,9
"N00001544",280,270,0,10,0,24,0,0,0,0,0,0,10,0,0,10,0,24,280,270,10
"N00001545",352,329,2,14,1,26,25,19,6,0,4,2,23,5,2,18,3,31,327,310,17
"N00001546",352,317,0,32,2,23,6,5,1,0,1,0,35,1,0,33,2,24,346,312,34
"N00001547",316,261,0,48,4,49,6,3,3,0,3,0,55,3,0,51,4,52,310,258,52
"N00001548",317,236,2,71,5,46,9,6,3,0,3,0,81,3,2,74,5,49,308,230,78
"N00001549",376,324,0,48,3,23,7,6,1,0,1,0,52,0,0,49,3,23,369,318,51
"N00001550",213,178,0,29,1,36,16,11,5,0,4,1,35,21,0,33,2,57,197,167,30
"N00001551",388,336,2,37,4,47,18,9,9,0,9,0,52,10,2,46,4,57,370,327,43
"N00001552",376,358,0,18,0,25,7,7,0,0,0,0,18,0,0,18,0,25,369,351,18
"N00001553",264,199,1,59,4,49,6,5,1,0,1,0,65,1,1,60,4,50,258,194,64
"N00001554",326,289,0,31,2,45,7,3,4,0,2,2,37,1,0,33,4,46,319,286,33
"N00001555",272,228,3,33,6,24,3,1,2,0,1,1,44,0,3,34,7,24,269,227,42
"N00001556",211,199,0,12,0,6,0,0,0,0,0,0,12,0,0,12,0,6,211,199,12
"N00001557",268,243,0,23,0,15,5,3,2,0,2,0,25,8,0,25,0,23,263,240,23
"N00001558",247,198,1,44,4,32,0,0,0,0,0,0,49,0,1,44,4,32,247,198,49
"N00001559",328,258,0,63,7,16,6,6,0,0,0,0,70,2,0,63,7,18,322,252,70
"N00001560",266,224,0,42,0,25,5,5,0,0,0,0,42,0,0,42,0,25,261,219,42
"N00001561",218,196,0,22,0,29,3,3,0,0,0,0,22,0,0,22,0,29,215,193,22
"N00001562",215,168,4,40,3,26,1,1,0,0,0,0,47,4,4,40,3,30,214,167,47
"N00001563",172,157,1,14,0,31,1,1,0,0,0,0,15,0,1,14,0,31,171,156,15
"N00001564",352,323,0,28,1,30,4,4,0,0,0,0,29,0,0,28,1,30,348,319,29
"N00001565",351,325,0,26,0,19,0,0,0,0,0,0,26,0,0,26,0,19,351,325,26
"N00001566",387,363,1,23,0,15,4,4,0,0,0,0,24,0,1,23,0,15,383,359,24
"N00001567",251,235,0,11,3,25,3,1,2,0,0,2,16,0,0,11,5,25,248,234,14
"N00001568",297,288,0,9,0,18,3,3,0,0,0,0,9,0,0,9,0,18,294,285,9
"N00001569",329,299,0,23,0,25,8,1,7,0,7,0,30,0,0,30,0,25,321,298,23
"N00001570",1119,1060,7,50,0,62,19,17,2,0,1,1,59,0,7,51,1,62,1100,1043,57
"N00001571",493,458,1,33,0,16,4,3,1,0,1,0,35,0,1,34,0,16,489,455,34
"N00001572",355,347,0,8,0,20,2,2,0,0,0,0,8,0,0,8,0,20,353,345,8
"N00001573",444,435,0,9,0,20,6,6,0,0,0,0,9,2,0,9,0,22,438,429,9
"N00001574",310,299,0,10,0,17,5,4,1,0,1,0,11,0,0,11,0,17,305,295,10
"N00001575",317,303,0,11,3,10,2,2,0,0,0,0,14,0,0,11,3,10,315,301,14
"N00001576",365,362,0,1,1,20,6,5,1,0,1,0,3,0,0,2,1,20,359,357,2
"N00001577",364,349,3,12,0,14,1,1,0,0,0,0,15,0,3,12,0,14,363,348,15
"N00001578",312,299,0,12,0,14,3,2,1,0,1,0,13,0,0,13,0,14,309,297,12
"N00001579",317,176,3,123,5,94,20,10,10,0,4,6,141,7,3,127,11,101,297,166,131
"N00001580",328,236,1,68,11,51,41,29,12,0,10,2,92,12,1,78,13,63,287,207,80
"N00001581",306,261,0,36,7,7,10,8,2,0,0,2,45,0,0,36,9,7,296,253,43
"N00001582",293,226,0,58,5,67,10,6,4,0,2,2,67,6,0,60,7,73,283,220,63
"N00001583",234,133,3,81,8,63,15,6,9,0,5,4,101,11,3,86,12,74,219,127,92
"N00001584",184,145,0,34,2,35,3,0,3,0,1,2,39,9,0,35,4,44,181,145,36
"N00001585",444,161,0,230,12,95,60,19,41,1,30,10,283,40,1,260,22,135,384,142,242
"N00001586",254,165,0,58,7,12,37,13,24,0,15,9,89,17,0,73,16,29,217,152,65
"N00001587",333,160,2,138,7,88,51,25,26,0,25,1,173,14,2,163,8,102,282,135,147
"N00001588",290,159,0,112,6,82,21,8,13,0,7,6,131,2,0,119,12,84,269,151,118
"N00001589",318,215,0,87,4,59,17,5,12,0,10,2,103,11,0,97,6,70,301,210,91
"N00001590",356,185,2,143,15,77,33,22,11,0,10,1,171,12,2,153,16,89,323,163,160
"N00001591",275,110,5,131,5,79,39,15,24,0,16,8,165,22,5,147,13,101,236,95,141
"N00001592",305,199,0,84,3,68,47,28,19,0,19,0,106,42,0,103,3,110,258,171,87
"N00001593",518,230,6,235,9,100,78,40,38,0,29,9,288,23,6,264,18,123,440,190,250
"N00001594",364,194,4,136,12,117,53,35,18,0,12,6,170,10,4,148,18,127,311,159,152
"N00001595",289,162,0,109,6,87,47,35,12,0,9,3,127,14,0,118,9,101,242,127,115
"N00001596",395,152,5,197,11,124,57,27,30,0,7,23,243,22,5,204,34,146,338,125,213
"N00001597",271,152,1,83,8,88,54,27,27,0,18,9,119,28,1,101,17,116,217,125,92
"N00001598",381,172,5,186,6,93,27,15,12,0,8,4,209,5,5,194,10,98,354,157,197
"N00001599",445,169,5,238,10,82,38,15,23,3,15,5,276,34,8,253,15,116,407,154,253
"N00001600",317,155,3,126,6,94,48,21,27,0,20,7,162,1,3,146,13,95,269,134,135
"N00001601",277,144,0,117,5,61,28,17,11,0,9,2,133,12,0,126,7,73,249,127,122
"N00001602",342,217,1,86,10,80,50,22,28,1,20,7,125,22,2,106,17,102,292,195,97
"N00001603",305,170,6,112,8,128,13,4,9,0,6,3,135,7,6,118,11,135,292,166,126
"N00001604",276,204,1,53,10,44,12,4,8,0,8,0,72,1,1,61,10,45,264,200,64
"N00001605",283,238,0,37,2,33,20,14,6,0,5,1,45,3,0,42,3,36,263,224,39
"N00001606",197,158,0,22,12,35,10,5,5,0,5,0,39,0,0,27,12,35,187,153,34
"N00001607",262,218,0,38,4,29,8,6,2,0,2,0,44,4,0,40,4,33,254,212,42
"N00001608",238,193,0,32,3,25,18,8,10,0,9,1,45,7,0,41,4,32,220,185,35
"N00001609",243,204,0,30,1,37,26,18,8,0,8,0,39,9,0,38,1,46,217,186,31
"N00001610",220,175,3,33,5,31,15,11,4,0,4,0,45,3,3,37,5,34,205,164,41
"N00001611",292,263,0,23,0,29,16,10,6,0,6,0,29,5,0,29,0,34,276,253,23
"N00001612",295,276,0,13,0,18,23,17,6,0,4,2,19,3,0,17,2,21,272,259,13
"N00001613",691,588,1,87,5,63,47,37,10,0,9,1,103,44,1,96,6,107,644,551,93
"N00001614",245,194,0,33,13,36,14,9,5,0,4,1,51,3,0,37,14,39,231,185,46
"N00001615",318,274,0,29,10,37,10,5,5,0,5,0,44,0,0,34,10,37,308,269,39
"N00001616",299,253,0,31,4,45,23,12,11,0,6,5,46,0,0,37,9,45,276,241,35
"N00001617",258,201,0,50,4,52,11,8,3,0,3,0,57,5,0,53,4,57,247,193,54
"N00001618",236,187,2,36,2,24,15,6,9,0,8,1,49,0,2,44,3,24,221,181,40
"N00001619",278,239,1,29,5,28,12,8,4,0,4,0,39,3,1,33,5,31,266,231,35
"N00001620",333,274,5,37,10,35,42,35,7,0,5,2,59,3,5,42,12,38,291,239,52
"N00001621",241,216,0,21,0,18,11,7,4,0,4,0,25,2,0,25,0,20,230,209,21
"N00001622",240,215,0,17,6,21,16,14,2,0,0,2,25,6,0,17,8,27,224,201,23
"N00001623",287,253,0,34,0,29,3,3,0,0,0,0,34,1,0,34,0,30,284,250,34
"N00001624",150,139,0,10,0,14,2,1,1,0,1,0,11,3,0,11,0,17,148,138,10
"N00001625",253,233,0,19,1,24,7,7,0,0,0,0,20,0,0,19,1,24,246,226,20
"N00001626",236,210,0,26,0,28,0,0,0,0,0,0,26,0,0,26,0,28,236,210,26
"N00001627",179,157,1,20,0,20,1,0,1,0,1,0,22,0,1,21,0,20,178,157,21
"N00001628",248,217,1,29,0,20,2,1,1,0,0,1,31,0,1,29,1,20,246,216,30
"N00001629",303,276,0,26,0,26,1,0,1,0,1,0,27,0,0,27,0,26,302,276,26
"N00001630",214,191,1,22,0,19,3,3,0,0,0,0,23,1,1,22,0,20,211,188,23
"N00001631",226,201,0,25,0,13,0,0,0,0,0,0,25,0,0,25,0,13,226,201,25
"N00001632",244,232,0,11,0,5,1,0,1,0,1,0,12,0,0,12,0,5,243,232,11
"N00001633",183,163,3,15,1,34,3,2,1,0,1,0,20,0,3,16,1,34,180,161,19
"N00001634",229,184,0,43,1,19,1,0,1,0,1,0,45,0,0,44,1,19,228,184,44
"N00001635",300,286,0,14,0,12,4,4,0,0,0,0,14,0,0,14,0,12,296,282,14
"N00001636",170,154,1,14,1,17,2,2,0,0,0,0,16,0,1,14,1,17,168,152,16
"N00001637",220,200,0,20,0,16,0,0,0,0,0,0,20,0,0,20,0,16,220,200,20
"N00001638",252,234,0,13,4,14,2,1,1,0,1,0,18,1,0,14,4,15,250,233,17
"N00001639",180,161,3,16,0,28,0,0,0,0,0,0,19,0,3,16,0,28,180,161,19
"N00001640",214,205,0,9,0,13,1,1,0,0,0,0,9,0,0,9,0,13,213,204,9
"N00001641",250,223,5,21,0,19,1,0,1,0,1,0,27,0,5,22,0,19,249,223,26
"N00001642",299,282,0,17,0,31,1,1,0,0,0,0,17,0,0,17,0,31,298,281,17
"N00001643",595,528,0,66,0,52,15,14,1,0,1,0,67,1,0,67,0,53,580,514,66
"N00001644",329,315,0,14,0,16,4,4,0,0,0,0,14,1,0,14,0,17,325,311,14
"N00001645",234,220,0,14,0,24,1,1,0,0,0,0,14,0,0,14,0,24,233,219,14
"N00001646",352,305,1,44,1,27,2,1,1,0,1,0,47,5,1,45,1,32,350,304,46
"N00001647",294,279,0,15,0,14,1,1,0,0,0,0,15,0,0,15,0,14,293,278,15
"N00001648",316,300,0,13,3,19,8,8,0,0,0,0,16,0,0,13,3,19,308,292,16
"N00001649",443,426,0,12,1,29,6,2,4,0,4,0,17,0,0,16,1,29,437,424,13
"N00001650",305,290,0,14,0,32,13,12,1,0,1,0,15,0,0,15,0,32,292,278,14
"N00001651",383,368,0,13,2,15,0,0,0,0,0,0,15,0,0,13,2,15,383,368,15
"N00001652",396,387,0,8,0,27,5,4,1,0,1,0,9,0,0,9,0,27,391,383,8
"N00001653",440,429,0,5,6,21,5,5,0,0,0,0,11,1,0,5,6,22,435,424,11
"N00001654",385,363,0,21,1,13,6,6,0,0,0,0,22,0,0,21,1,13,379,357,22
"N00001655",386,360,0,24,1,44,4,3,1,0,1,0,26,1,0,25,1,45,382,357,25
"N00001656",234,223,0,11,0,9,0,0,0,0,0,0,11,0,0,11,0,9,234,223,11
"N00001657",292,275,0,12,1,13,10,6,4,0,4,0,17,0,0,16,1,13,282,269,13
"N00001658",209,197,0,12,0,6,0,0,0,0,0,0,12,0,0,12,0,6,209,197,12
"N00001659",248,241,0,7,0,5,0,0,0,0,0,0,7,0,0,7,0,5,248,241,7
"N00001660",294,283,1,9,1,22,1,1,0,0,0,0,11,2,1,9,1,24,293,282,11
"N00001661",373,360,0,11,2,8,2,2,0,0,0,0,13,0,0,11,2,8,371,358,13
"N00001662",325,310,2,13,0,16,0,0,0,0,0,0,15,0,2,13,0,16,325,310,15
"N00001663",316,306,0,9,0,19,2,1,1,0,1,0,10,0,0,10,0,19,314,305,9
"N00001664",325,313,0,11,1,26,6,6,0,0,0,0,12,1,0,11,1,27,319,307,12
"N00001665",370,349,0,20,1,18,1,1,0,0,0,0,21,0,0,20,1,18,369,348,21
"N00001666",340,325,0,15,0,26,2,2,0,0,0,0,15,0,0,15,0,26,338,323,15
"N00001667",301,284,0,16,1,24,0,0,0,0,0,0,17,0,0,16,1,24,301,284,17
"N00001668",391,379,0,12,0,21,0,0,0,0,0,0,12,0,0,12,0,21,391,379,12
"N00001669",326,316,0,9,1,22,8,8,0,0,0,0,10,0,0,9,1,22,318,308,10
"N00001670",263,224,0,39,0,10,3,3,0,0,0,0,39,0,0,39,0,10,260,221,39
"N00001671",302,268,0,34,0,26,1,1,0,0,0,0,34,0,0,34,0,26,301,267,34
"N00001672",368,331,0,36,1,29,0,0,0,0,0,0,37,0,0,36,1,29,368,331,37
"N00001673",447,394,0,49,4,45,6,6,0,0,0,0,53,0,0,49,4,45,441,388,53
"N00001674",248,217,0,28,3,22,1,1,0,0,0,0,31,0,0,28,3,22,247,216,31
"N00001675",279,263,0,16,0,18,1,1,0,0,0,0,16,0,0,16,0,18,278,262,16
"N00001676",264,241,0,23,0,33,1,1,0,0,0,0,23,0,0,23,0,33,263,240,23
"N00001677",552,544,0,6,2,18,9,9,0,0,0,0,8,0,0,6,2,18,543,535,8
"N00001678",435,398,0,36,1,20,3,3,0,0,0,0,37,0,0,36,1,20,432,395,37
"N00001679",404,398,0,5,1,23,3,3,0,0,0,0,6,0,0,5,1,23,401,395,6
"N00001680",540,518,0,16,4,30,8,6,2,0,1,1,22,0,0,17,5,30,532,512,20
"N00001681",300,258,0,40,1,36,2,1,1,0,1,0,42,0,0,41,1,36,298,257,41
"N00001682",324,307,0,17,0,26,1,1,0,0,0,0,17,0,0,17,0,26,323,306,17
"N00001683",388,337,4,47,0,19,6,6,0,0,0,0,51,1,4,47,0,20,382,331,51
"N00001684",930,894,4,32,0,33,18,18,0,0,0,0,36,0,4,32,0,33,912,876,36
"N00001685",337,323,0,14,0,18,0,0,0,0,0,0,14,0,0,14,0,18,337,323,14
"N00001686",279,261,0,18,0,24,10,10,0,0,0,0,18,4,0,18,0,28,269,251,18
"N00001687",308,301,0,5,2,10,5,5,0,0,0,0,7,0,0,5,2,10,303,296,7
"N00001688",361,343,0,17,1,16,3,3,0,0,0,0,18,0,0,17,1,16,358,340,18
"N00001689",246,201,2,41,2,50,2,2,0,0,0,0,45,2,2,41,2,52,244,199,45
"N00001690",352,336,0,13,0,17,7,4,3,0,3,0,16,0,0,16,0,17,345,332,13
"N00001691",280,237,4,38,0,41,4,3,1,0,1,0,43,1,4,39,0,42,276,234,42
"N00001692",254,230,3,21,0,26,4,4,0,0,0,0,24,0,3,21,0,26,250,226,24
"N00001693",311,261,0,49,1,23,0,0,0,0,0,0,50,0,0,49,1,23,311,261,50
"N00001694",293,277,0,15,0,9,4,3,1,0,0,1,16,0,0,15,1,9,289,274,15
"N00001695",414,388,0,26,0,26,7,7,0,0,0,0,26,3,0,26,0,29,407,381,26
"N00001696",379,340,1,36,1,32,8,7,1,0,0,1,39,0,1,36,2,32,371,333,38
"N00001697",298,282,0,15,1,21,6,6,0,0,0,0,16,0,0,15,1,21,292,276,16
"N00001698",269,237,2,29,0,37,5,4,1,0,1,0,32,0,2,30,0,37,264,233,31
"N00001699",395,370,3,21,1,48,10,10,0,0,0,0,25,5,3,21,1,53,385,360,25
"N00001700",260,248,0,12,0,18,1,1,0,0,0,0,12,0,0,12,0,18,259,247,12
"N00001701",198,178,1,19,0,18,3,3,0,0,0,0,20,2,1,19,0,20,195,175,20
"N00001702",338,307,0,26,4,30,8,7,1,0,1,0,31,0,0,27,4,30,330,300,30
"N00001703",1033,918,4,96,9,94,26,20,6,0,1,5,115,5,4,97,14,99,1007,898,109
"N00001704",829,716,5,98,8,88,30,28,2,0,2,0,113,6,5,100,8,94,799,688,111
"N00001705",222,187,1,31,0,17,13,10,3,0,2,1,35,1,1,33,1,18,209,177,32
"N00001706",465,429,0,36,0,23,1,1,0,0,0,0,36,7,0,36,0,30,464,428,36
"N00001707",395,379,0,13,3,41,8,8,0,0,0,0,16,0,0,13,3,41,387,371,16
"N00001708",674,635,6,32,0,29,6,5,1,0,0,1,39,0,6,32,1,29,668,630,38
"N00001709",252,223,0,26,3,22,0,0,0,0,0,0,29,1,0,26,3,23,252,223,29
"N00001710",341,337,0,4,0,10,0,0,0,0,0,0,4,0,0,4,0,10,341,337,4
"N00001711",362,362,0,0,0,18,5,5,0,0,0,0,0,0,0,0,0,18,357,357,0
"N00001712",387,350,0,36,0,22,1,0,1,0,1,0,37,0,0,37,0,22,386,350,36
"N00001713",207,188,0,19,0,27,0,0,0,0,0,0,19,0,0,19,0,27,207,188,19
"N00001714",536,482,0,50,4,56,5,5,0,0,0,0,54,2,0,50,4,58,531,477,54
"N00001715",287,270,3,14,0,28,1,1,0,0,0,0,17,0,3,14,0,28,286,269,17
"N00001716",303,288,0,15,0,12,3,3,0,0,0,0,15,0,0,15,0,12,300,285,15
"N00001717",352,333,0,18,1,18,7,7,0,0,0,0,19,0,0,18,1,18,345,326,19
"N00001718",288,278,0,10,0,19,2,2,0,0,0,0,10,0,0,10,0,19,286,276,10
"N00001719",320,300,7,13,0,9,3,3,0,0,0,0,20,0,7,13,0,9,317,297,20
"N00001720",289,264,0,25,0,17,2,2,0,0,0,0,25,0,0,25,0,17,287,262,25
"N00001721",279,264,0,15,0,32,0,0,0,0,0,0,15,1,0,15,0,33,279,264,15
"N00001722",335,287,0,48,0,27,2,2,0,0,0,0,48,1,0,48,0,28,333,285,48
"N00001723",289,260,0,28,0,36,1,0,1,0,1,0,29,0,0,29,0,36,288,260,28
"N00001724",244,230,0,13,1,31,2,2,0,0,0,0,14,0,0,13,1,31,242,228,14
"N00001725",260,232,0,25,2,50,1,0,1,0,1,0,28,1,0,26,2,51,259,232,27
"N00001726",263,250,0,13,0,32,5,5,0,0,0,0,13,0,0,13,0,32,258,245,13
"N00001727",222,210,0,12,0,23,5,5,0,0,0,0,12,0,0,12,0,23,217,205,12
"N00001728",292,252,0,40,0,15,2,2,0,0,0,0,40,0,0,40,0,15,290,250,40
"N00001729",312,271,3,33,4,12,1,0,1,0,1,0,41,0,3,34,4,12,311,271,40
"N00001730",214,185,0,27,1,17,2,1,1,0,1,0,29,0,0,28,1,17,212,184,28
"N00001731",227,211,0,16,0,13,1,1,0,0,0,0,16,0,0,16,0,13,226,210,16
"N00001732",1089,1031,2,50,2,72,34,30,4,0,3,1,58,3,2,53,3,75,1055,1001,54
"N00001733",282,261,0,21,0,32,2,2,0,0,0,0,21,2,0,21,0,34,280,259,21
"N00001734",287,267,0,20,0,12,4,4,0,0,0,0,20,0,0,20,0,12,283,263,20
"N00001735",268,238,2,26,2,30,0,0,0,0,0,0,30,1,2,26,2,31,268,238,30
"N00001736",352,314,3,32,2,13,2,1,1,0,1,0,38,0,3,33,2,13,350,313,37
"N00001737",352,311,0,37,3,40,3,2,1,0,1,0,41,2,0,38,3,42,349,309,40
"N00001738",317,297,0,18,2,24,2,2,0,0,0,0,20,0,0,18,2,24,315,295,20
"N00001739",352,320,0,19,7,13,10,4,6,0,2,4,32,0,0,21,11,13,342,316,26
"N00001740",694,668,1,23,1,50,13,12,1,0,1,0,26,1,1,24,1,51,681,656,25
"N00001741",284,248,0,29,1,20,11,5,6,0,3,3,36,0,0,32,4,20,273,243,30
"N00001742",229,206,0,23,0,18,4,4,0,0,0,0,23,0,0,23,0,18,225,202,23
"N00001743",283,257,0,20,5,18,9,8,1,0,1,0,26,0,0,21,5,18,274,249,25
"N00001744",325,308,0,13,4,11,0,0,0,0,0,0,17,0,0,13,4,11,325,308,17
"N00001745",336,312,0,23,0,28,2,1,1,0,1,0,24,2,0,24,0,30,334,311,23
"N00001746",295,280,0,12,1,14,4,2,2,0,2,0,15,0,0,14,1,14,291,278,13
"N00001747",742,688,2,46,4,52,8,6,2,0,1,1,54,0,2,47,5,52,734,682,52
"N00001748",456,439,1,15,1,22,0,0,0,0,0,0,17,0,1,15,1,22,456,439,17
"N00001749",325,309,1,13,2,27,0,0,0,0,0,0,16,0,1,13,2,27,325,309,16
"N00001750",256,235,0,19,1,21,10,9,1,0,1,0,21,1,0,20,1,22,246,226,20
"N00001751",318,289,0,29,0,23,12,12,0,0,0,0,29,0,0,29,0,23,306,277,29
"N00001752",299,292,0,7,0,9,1,1,0,0,0,0,7,8,0,7,0,17,298,291,7
"N00001753",321,304,2,15,0,25,12,12,0,0,0,0,17,0,2,15,0,25,309,292,17
"N00001754",356,331,1,19,2,28,15,12,3,0,3,0,25,1,1,22,2,29,341,319,22
"N00001755",380,363,0,15,2,25,0,0,0,0,0,0,17,1,0,15,2,26,380,363,17
"N00001756",326,314,0,12,0,22,0,0,0,0,0,0,12,1,0,12,0,23,326,314,12
"N00001757",243,223,0,16,0,25,15,11,4,0,3,1,20,0,0,19,1,25,228,212,16
"N00001758",272,262,0,9,1,22,2,2,0,0,0,0,10,0,0,9,1,22,270,260,10
"N00001759",313,298,0,15,0,21,0,0,0,0,0,0,15,0,0,15,0,21,313,298,15
"N00001760",1278,1162,3,90,5,99,75,57,18,3,12,3,116,2,6,102,8,101,1203,1105,98
"N00001761",503,458,0,43,0,31,21,19,2,0,2,0,45,3,0,45,0,34,482,439,43
"N00001762",275,264,0,11,0,20,15,15,0,0,0,0,11,0,0,11,0,20,260,249,11
"N00001763",1425,1330,1,80,6,114,67,59,8,0,8,0,95,0,1,88,6,114,1358,1271,87
"N00001764",234,210,1,22,0,16,3,2,1,0,1,0,24,0,1,23,0,16,231,208,23
"N00001765",990,884,1,95,9,60,34,33,1,0,1,0,106,4,1,96,9,64,956,851,105
"N00001766",256,232,0,22,2,12,1,1,0,0,0,0,24,0,0,22,2,12,255,231,24
"N00001767",299,287,2,10,0,25,8,8,0,0,0,0,12,4,2,10,0,29,291,279,12
"N00001768",296,286,0,9,0,24,12,11,1,0,1,0,10,0,0,10,0,24,284,275,9
"N00001769",374,348,0,20,2,24,30,26,4,0,4,0,26,1,0,24,2,25,344,322,22
"N00001770",333,316,0,9,0,4,11,3,8,0,4,4,17,1,0,13,4,5,322,313,9
"N00001771",437,380,0,46,1,39,32,22,10,0,10,0,57,1,0,56,1,40,405,358,47
"N00001772",278,268,0,8,0,18,10,8,2,0,2,0,10,0,0,10,0,18,268,260,8
"N00001773",278,266,0,12,0,19,11,11,0,0,0,0,12,0,0,12,0,19,267,255,12
"N00001774",281,261,0,14,2,14,13,9,4,0,4,0,20,0,0,18,2,14,268,252,16
"N00001775",301,291,0,10,0,24,10,10,0,0,0,0,10,1,0,10,0,25,291,281,10
"N00001776",294,273,1,19,1,18,9,9,0,0,0,0,21,4,1,19,1,22,285,264,21
"N00001777",352,337,0,13,0,13,15,13,2,0,2,0,15,0,0,15,0,13,337,324,13
"N00001778",307,283,0,21,1,25,24,22,2,0,1,1,24,0,0,22,2,25,283,261,22
"N00001779",293,274,0,19,0,21,6,6,0,0,0,0,19,0,0,19,0,21,287,268,19
"N00001780",621,466,1,147,0,52,18,11,7,0,7,0,155,0,1,154,0,52,603,455,148
"N00001781",429,401,0,27,0,14,21,20,1,0,1,0,28,4,0,28,0,18,408,381,27
"N00001782",354,336,0,16,0,18,7,5,2,0,2,0,18,1,0,18,0,19,347,331,16
"N00001783",348,345,0,2,0,20,17,16,1,0,1,0,3,0,0,3,0,20,331,329,2
"N00001784",257,225,2,27,0,17,7,4,3,0,3,0,32,0,2,30,0,17,250,221,29
"N00001785",348,333,1,13,1,11,8,8,0,0,0,0,15,0,1,13,1,11,340,325,15
"N00001786",319,311,0,7,1,18,0,0,0,0,0,0,8,0,0,7,1,18,319,311,8
"N00001787",281,260,4,13,1,18,4,1,3,0,3,0,21,0,4,16,1,18,277,259,18
"N00001788",335,324,0,10,1,14,10,10,0,0,0,0,11,1,0,10,1,15,325,314,11
"N00001789",425,376,0,48,0,33,6,5,1,0,1,0,49,2,0,49,0,35,419,371,48
"N00001790",359,334,0,24,1,18,0,0,0,0,0,0,25,4,0,24,1,22,359,334,25
"N00001791",474,441,0,30,2,22,11,10,1,0,1,0,33,0,0,31,2,22,463,431,32
"N00001792",345,332,0,12,1,26,18,18,0,0,0,0,13,0,0,12,1,26,327,314,13
"N00001793",456,446,0,10,0,15,20,20,0,0,0,0,10,0,0,10,0,15,436,426,10
"N00001794",915,826,8,69,2,72,28,18,10,0,8,2,89,4,8,77,4,76,887,808,79
"N00001795",320,301,0,19,0,27,11,11,0,0,0,0,19,0,0,19,0,27,309,290,19
"N00001796",336,316,3,11,0,20,28,22,6,2,3,1,20,0,5,14,1,20,308,294,14
"N00001797",341,319,0,15,2,15,8,3,5,0,5,0,22,3,0,20,2,18,333,316,17
"N00001798",423,399,0,20,0,28,10,6,4,0,3,1,24,0,0,23,1,28,413,393,20
"N00001799",314,300,0,12,2,7,0,0,0,0,0,0,14,0,0,12,2,7,314,300,14
"N00001800",343,328,0,12,0,17,10,7,3,0,3,0,15,0,0,15,0,17,333,321,12
"N00001801",439,430,0,9,0,12,28,28,0,0,0,0,9,1,0,9,0,13,411,402,9
"N00001802",331,294,3,28,0,24,12,6,6,0,6,0,37,6,3,34,0,30,319,288,31
"N00001803",302,277,0,25,0,15,1,1,0,0,0,0,25,0,0,25,0,15,301,276,25
"N00001804",353,341,0,10,0,19,4,2,2,0,2,0,12,0,0,12,0,19,349,339,10
"N00001805",893,812,7,65,7,86,23,21,2,0,2,0,81,4,7,67,7,90,870,791,79
"N00001806",324,299,0,24,1,17,5,5,0,0,0,0,25,1,0,24,1,18,319,294,25
"N00001807",249,219,1,26,0,30,11,8,3,0,3,0,30,0,1,29,0,30,238,211,27
"N00001808",249,245,0,4,0,2,1,1,0,0,0,0,4,0,0,4,0,2,248,244,4
"N00001809",255,253,0,2,0,12,11,11,0,0,0,0,2,1,0,2,0,13,244,242,2
"N00001810",231,212,0,19,0,12,0,0,0,0,0,0,19,0,0,19,0,12,231,212,19
"N00001811",249,227,0,20,0,7,4,2,2,0,2,0,22,0,0,22,0,7,245,225,20
"N00001812",340,303,0,36,1,37,4,4,0,0,0,0,37,0,0,36,1,37,336,299,37
"N00001813",193,174,0,19,0,4,4,4,0,0,0,0,19,0,0,19,0,4,189,170,19
"N00001814",644,583,0,59,1,54,15,14,1,0,1,0,61,6,0,60,1,60,629,569,60
"N00001815",347,324,0,21,1,21,2,1,1,0,1,0,23,0,0,22,1,21,345,323,22
"N00001816",486,440,0,42,3,29,3,2,1,0,1,0,46,1,0,43,3,30,483,438,45
"N00001817",287,269,0,18,0,17,4,4,0,0,0,0,18,2,0,18,0,19,283,265,18
"N00001818",274,257,0,17,0,23,6,6,0,0,0,0,17,0,0,17,0,23,268,251,17
"N00001819",379,342,0,34,1,18,14,12,2,0,2,0,37,0,0,36,1,18,365,330,35
"N00001820",314,301,0,13,0,21,21,21,0,0,0,0,13,5,0,13,0,26,293,280,13
"N00001821",618,547,0,59,2,62,72,62,10,3,4,3,71,20,3,63,5,82,546,485,61
"N00001822",270,246,0,21,1,10,6,4,2,0,2,0,24,10,0,23,1,20,264,242,22
"N00001823",383,364,0,15,0,23,13,9,4,0,4,0,19,0,0,19,0,23,370,355,15
"N00001824",365,358,0,6,0,28,7,6,1,0,1,0,7,0,0,7,0,28,358,352,6
"N00001825",240,225,0,10,3,19,13,11,2,0,1,1,15,12,0,11,4,31,227,214,13
"N00001826",344,333,0,11,0,28,7,7,0,0,0,0,11,0,0,11,0,28,337,326,11
"N00001827",334,323,0,6,0,9,22,17,5,0,5,0,11,4,0,11,0,13,312,306,6
"N00001828",257,227,0,20,0,9,21,11,10,0,10,0,30,2,0,30,0,11,236,216,20
"N00001829",238,227,0,8,3,12,16,16,0,0,0,0,11,0,0,8,3,12,222,211,11
"N00001830",393,365,0,27,0,32,10,9,1,0,0,1,28,0,0,27,1,32,383,356,27
"N00001831",337,307,6,22,2,18,3,3,0,0,0,0,30,0,6,22,2,18,334,304,30
"N00001832",251,245,0,4,2,14,2,2,0,0,0,0,6,2,0,4,2,16,249,243,6
"N00001833",327,285,0,40,0,26,3,1,2,0,2,0,42,0,0,42,0,26,324,284,40
"N00001834",235,224,0,9,0,7,5,3,2,0,0,2,11,0,0,9,2,7,230,221,9
"N00001835",295,281,0,12,1,14,11,10,1,0,1,0,14,0,0,13,1,14,284,271,13
"N00001836",284,255,0,28,1,8,3,3,0,0,0,0,29,2,0,28,1,10,281,252,29
"N00001837",236,220,0,16,0,15,5,5,0,0,0,0,16,0,0,16,0,15,231,215,16
"N00001838",234,217,0,16,0,15,2,1,1,0,1,0,17,1,0,17,0,16,232,216,16
"N00001839",396,331,0,63,2,20,10,10,0,0,0,0,65,2,0,63,2,22,386,321,65
"N00001840",374,362,0,12,0,26,4,4,0,0,0,0,12,0,0,12,0,26,370,358,12
"N00001841",345,326,0,18,1,8,19,19,0,0,0,0,19,0,0,18,1,8,326,307,19
"N00001842",258,237,0,20,0,28,10,9,1,0,1,0,21,0,0,21,0,28,248,228,20
"N00001843",326,309,0,16,0,13,10,9,1,0,1,0,17,0,0,17,0,13,316,300,16
"N00001844",297,277,0,17,2,14,7,6,1,0,1,0,20,0,0,18,2,14,290,271,19
"N00001845",292,277,0,13,1,7,9,8,1,0,1,0,15,0,0,14,1,7,283,269,14
"N00001846",279,259,0,19,1,13,4,4,0,0,0,0,20,2,0,19,1,15,275,255,20
"N00001847",287,269,0,17,1,5,4,4,0,0,0,0,18,0,0,17,1,5,283,265,18
"N00001848",298,272,0,22,4,29,1,1,0,0,0,0,26,0,0,22,4,29,297,271,26
"N00001849",303,289,0,14,0,18,3,3,0,0,0,0,14,0,0,14,0,18,300,286,14
"N00001850",636,609,1,23,3,47,1,1,0,0,0,0,27,0,1,23,3,47,635,608,27
"N00001851",295,284,0,11,0,19,3,3,0,0,0,0,11,0,0,11,0,19,292,281,11
"N00001852",349,309,0,38,1,20,11,10,1,0,1,0,40,0,0,39,1,20,338,299,39
"N00001853",344,318,0,26,0,31,0,0,0,0,0,0,26,0,0,26,0,31,344,318,26
"N00001854",232,206,0,24,0,21,2,0,2,0,2,0,26,1,0,26,0,22,230,206,24
"N00001855",292,263,0,17,3,25,29,20,9,0,9,0,29,1,0,26,3,26,263,243,20
"N00001856",272,247,0,22,0,25,33,30,3,0,3,0,25,5,0,25,0,30,239,217,22
"N00001857",268,241,0,23,0,18,14,10,4,0,4,0,27,1,0,27,0,19,254,231,23
"N00001858",232,219,0,8,1,10,9,5,4,0,0,4,13,0,0,8,5,10,223,214,9
"N00001859",266,242,3,21,0,13,1,1,0,0,0,0,24,0,3,21,0,13,265,241,24
"N00001860",210,195,0,11,0,14,9,5,4,0,1,3,15,0,0,12,3,14,201,190,11
"N00001861",271,244,1,19,5,13,8,6,2,0,1,1,27,0,1,20,6,13,263,238,25
"N00001862",387,345,0,22,8,27,43,31,12,0,6,6,42,15,0,28,14,42,344,314,30
"N00001863",272,252,0,19,1,18,19,19,0,0,0,0,20,4,0,19,1,22,253,233,20
"N00001864",364,326,1,33,0,20,10,6,4,0,4,0,38,2,1,37,0,22,354,320,34
"N00001865",541,530,0,11,0,15,5,5,0,0,0,0,11,0,0,11,0,15,536,525,11
"N00001866",252,244,0,7,0,4,10,9,1,0,0,1,8,0,0,7,1,4,242,235,7
"N00001867",359,333,1,22,3,17,6,6,0,0,0,0,26,0,1,22,3,17,353,327,26
"N00001868",372,359,0,12,1,25,1,1,0,0,0,0,13,0,0,12,1,25,371,358,13
"N00001869",350,315,0,35,0,27,0,0,0,0,0,0,35,2,0,35,0,29,350,315,35
"N00001870",323,317,0,5,1,10,6,6,0,0,0,0,6,0,0,5,1,10,317,311,6
"N00001871",355,334,3,17,0,14,27,26,1,0,1,0,21,1,3,18,0,15,328,308,20
"N00001872",256,233,0,14,2,5,34,27,7,1,6,0,23,2,1,20,2,7,222,206,16
"N00001873",806,742,3,53,4,57,38,34,4,0,3,1,64,3,3,56,5,60,768,708,60
"N00001874",376,367,0,4,1,20,20,16,4,0,4,0,9,1,0,8,1,21,356,351,5
"N00001875",291,280,0,10,1,16,8,8,0,0,0,0,11,0,0,10,1,16,283,272,11
"N00001876",332,293,0,33,2,20,7,3,4,0,4,0,39,1,0,37,2,21,325,290,35
"N00001877",282,273,0,8,1,5,1,1,0,0,0,0,9,0,0,8,1,5,281,272,9
"N00001878",307,293,0,13,1,19,4,4,0,0,0,0,14,1,0,13,1,20,303,289,14
"N00001879",352,337,3,12,0,18,7,7,0,0,0,0,15,0,3,12,0,18,345,330,15
"N00001880",313,304,0,9,0,23,4,4,0,0,0,0,9,0,0,9,0,23,309,300,9
"N00001881",979,930,0,48,0,57,4,3,1,0,0,1,49,0,0,48,1,57,975,927,48
"N00001882",281,259,0,22,0,27,0,0,0,0,0,0,22,4,0,22,0,31,281,259,22
"N00001883",292,271,0,21,0,11,3,3,0,0,0,0,21,0,0,21,0,11,289,268,21
"N00001884",261,253,0,4,4,25,3,3,0,0,0,0,8,0,0,4,4,25,258,250,8
"N00001885",229,212,1,16,0,6,0,0,0,0,0,0,17,0,1,16,0,6,229,212,17
"N00001886",232,211,3,18,0,9,0,0,0,0,0,0,21,0,3,18,0,9,232,211,21
"N00001887",289,258,0,31,0,25,7,7,0,0,0,0,31,5,0,31,0,30,282,251,31
"N00001888",287,268,0,19,0,19,8,8,0,0,0,0,19,0,0,19,0,19,279,260,19
"N00001889",231,211,2,16,0,25,5,3,2,0,2,0,20,0,2,18,0,25,226,208,18
"N00001890",555,517,0,30,2,22,21,15,6,0,6,0,38,0,0,36,2,22,534,502,32
"N00001891",390,370,0,18,1,25,14,13,1,0,1,0,20,2,0,19,1,27,376,357,19
"N00001892",280,268,0,12,0,14,1,1,0,0,0,0,12,0,0,12,0,14,279,267,12
"N00001893",270,252,0,15,0,35,3,0,3,0,3,0,18,1,0,18,0,36,267,252,15
"N00001894",320,302,0,16,1,34,12,11,1,0,1,0,18,0,0,17,1,34,308,291,17
"N00001895",342,318,1,22,0,23,15,14,1,0,1,0,24,1,1,23,0,24,327,304,23
"N00001896",546,501,0,40,0,58,18,13,5,0,4,1,45,2,0,44,1,60,528,488,40
"N00001897",283,259,0,23,0,9,3,2,1,0,1,0,24,0,0,24,0,9,280,257,23
"N00001898",279,254,0,23,0,30,10,8,2,0,2,0,25,0,0,25,0,30,269,246,23
"N00001899",186,168,1,16,1,10,8,8,0,0,0,0,18,0,1,16,1,10,178,160,18
"N00001900",346,332,0,10,2,26,6,4,2,0,0,2,14,0,0,10,4,26,340,328,12
"N00001901",377,360,1,16,0,26,7,7,0,0,0,0,17,0,1,16,0,26,370,353,17
"N00001902",411,399,0,11,0,16,6,5,1,0,1,0,12,0,0,12,0,16,405,394,11
"N00001903",427,407,0,16,1,16,3,0,3,0,0,3,20,2,0,16,4,18,424,407,17
"N00001904",265,249,0,15,1,9,7,7,0,0,0,0,16,0,0,15,1,9,258,242,16
"N00001905",267,263,0,2,2,10,2,2,0,0,0,0,4,0,0,2,2,10,265,261,4
"N00001906",308,289,1,12,1,28,8,3,5,0,5,0,19,0,1,17,1,28,300,286,14
"N00001907",331,317,0,14,0,15,0,0,0,0,0,0,14,0,0,14,0,15,331,317,14
"N00001908",321,304,5,12,0,21,0,0,0,0,0,0,17,0,5,12,0,21,321,304,17
"N00001909",331,317,0,13,0,7,1,0,1,0,1,0,14,0,0,14,0,7,330,317,13
"N00001910",386,376,0,10,0,27,0,0,0,0,0,0,10,0,0,10,0,27,386,376,10
"N00001911",290,260,0,18,6,42,24,18,6,0,5,1,30,7,0,23,7,49,266,242,24
"N00001912",428,354,2,61,8,43,18,15,3,0,3,0,74,0,2,64,8,43,410,339,71
"N00001913",280,268,0,6,0,20,15,9,6,0,6,0,12,1,0,12,0,21,265,259,6
"N00001914",303,275,0,26,0,22,27,25,2,0,1,1,28,13,0,27,1,35,276,250,26
"N00001915",651,590,0,44,8,24,27,18,9,0,6,3,61,2,0,50,11,26,624,572,52
"N00001916",267,247,0,18,0,27,9,7,2,0,2,0,20,15,0,20,0,42,258,240,18
"N00001917",312,275,1,36,0,30,7,7,0,0,0,0,37,0,1,36,0,30,305,268,37
"N00001918",249,224,0,22,0,26,14,11,3,0,3,0,25,0,0,25,0,26,235,213,22
"N00001919",324,300,3,20,0,28,4,3,1,0,1,0,24,0,3,21,0,28,320,297,23
"N00001920",327,311,0,13,2,21,1,0,1,0,1,0,16,0,0,14,2,21,326,311,15
"N00001921",272,258,0,14,0,17,0,0,0,0,0,0,14,0,0,14,0,17,272,258,14
"N00001922",300,288,0,11,1,12,2,2,0,0,0,0,12,10,0,11,1,22,298,286,12
"N00001923",236,216,0,20,0,23,0,0,0,0,0,0,20,1,0,20,0,24,236,216,20
"N00001924",367,330,0,33,3,34,16,15,1,0,1,0,37,0,0,34,3,34,351,315,36
"N00001925",273,258,0,15,0,29,1,1,0,0,0,0,15,0,0,15,0,29,272,257,15
"N00001926",320,305,0,15,0,18,0,0,0,0,0,0,15,0,0,15,0,18,320,305,15
"N00001927",225,208,0,17,0,25,6,6,0,0,0,0,17,1,0,17,0,26,219,202,17
"N00001928",232,212,0,18,2,11,5,5,0,0,0,0,20,0,0,18,2,11,227,207,20
"N00001929",440,415,0,23,1,61,5,4,1,0,1,0,25,0,0,24,1,61,435,411,24
"N00001930",249,235,1,12,0,10,4,3,1,0,0,1,14,0,1,12,1,10,245,232,13
"N00001931",267,250,0,17,0,20,4,4,0,0,0,0,17,0,0,17,0,20,263,246,17
"N00001932",278,263,0,15,0,15,0,0,0,0,0,0,15,0,0,15,0,15,278,263,15
"N00001933",292,285,0,5,1,9,3,2,1,0,1,0,7,0,0,6,1,9,289,283,6
"N00001934",265,251,0,11,3,14,1,1,0,0,0,0,14,0,0,11,3,14,264,250,14
"N00001935",350,316,5,28,0,26,8,7,1,0,0,1,34,0,5,28,1,26,342,309,33
"N00001936",304,264,0,39,1,30,2,2,0,0,0,0,40,0,0,39,1,30,302,262,40
"N00001937",304,296,0,6,2,18,1,1,0,0,0,0,8,0,0,6,2,18,303,295,8
"N00001938",311,290,0,19,0,27,16,14,2,0,1,1,21,5,0,20,1,32,295,276,19
"N00001939",278,259,2,17,0,19,0,0,0,0,0,0,19,0,2,17,0,19,278,259,19
"N00001940",359,332,0,25,1,16,14,13,1,0,1,0,27,0,0,26,1,16,345,319,26
"N00001941",284,254,0,24,1,23,6,1,5,0,5,0,30,0,0,29,1,23,278,253,25
"N00001942",451,425,0,24,1,21,6,5,1,0,1,0,26,0,0,25,1,21,445,420,25
"N00001943",429,411,0,15,0,14,3,0,3,0,0,3,18,0,0,15,3,14,426,411,15
"N00001944",365,351,1,12,1,18,2,2,0,0,0,0,14,0,1,12,1,18,363,349,14
"N00001945",440,421,1,15,3,10,0,0,0,0,0,0,19,0,1,15,3,10,440,421,19
"N00001946",352,341,0,7,4,5,8,8,0,0,0,0,11,0,0,7,4,5,344,333,11
"N00001947",462,437,0,25,0,30,3,3,0,0,0,0,25,0,0,25,0,30,459,434,25
"N00001948",216,201,0,15,0,12,0,0,0,0,0,0,15,1,0,15,0,13,216,201,15
"N00001949",685,590,1,85,8,48,3,2,1,0,0,1,95,0,1,85,9,48,682,588,94
"N00001950",230,199,1,25,4,16,2,1,1,0,1,0,31,2,1,26,4,18,228,198,30
"N00001951",238,213,0,24,0,20,1,0,1,0,1,0,25,0,0,25,0,20,237,213,24
"N00001952",266,226,8,31,1,12,1,1,0,0,0,0,40,0,8,31,1,12,265,225,40
"N00001953",200,180,0,20,0,28,1,1,0,0,0,0,20,0,0,20,0,28,199,179,20
"N00001954",254,238,0,16,0,12,1,1,0,0,0,0,16,0,0,16,0,12,253,237,16
"N00001955",285,220,8,52,3,27,3,1,2,0,2,0,65,2,8,54,3,29,282,219,63
"N00001956",207,173,4,29,0,19,7,6,1,0,1,0,34,0,4,30,0,19,200,167,33
"N00001957",294,269,0,24,1,20,5,5,0,0,0,0,25,3,0,24,1,23,289,264,25
"N00001958",326,286,2,36,2,27,0,0,0,0,0,0,40,0,2,36,2,27,326,286,40
"N00001959",261,233,0,26,0,25,3,1,2,0,2,0,28,0,0,28,0,25,258,232,26
"N00001960",318,286,2,30,0,14,0,0,0,0,0,0,32,0,2,30,0,14,318,286,32
"N00001961",419,390,3,26,0,41,10,10,0,0,0,0,29,0,3,26,0,41,409,380,29
"N00001962",209,199,0,7,3,9,3,3,0,0,0,0,10,0,0,7,3,9,206,196,10
"N00001963",167,148,2,17,0,13,2,2,0,0,0,0,19,0,2,17,0,13,165,146,19
"N00001964",269,249,0,20,0,26,0,0,0,0,0,0,20,1,0,20,0,27,269,249,20
"N00001965",304,288,0,14,2,11,4,4,0,0,0,0,16,0,0,14,2,11,300,284,16
"N00001966",434,399,0,31,2,25,4,2,2,0,2,0,35,0,0,33,2,25,430,397,33
"N00001967",468,454,0,7,3,8,5,1,4,0,2,2,14,0,0,9,5,8,463,453,10
"N00001968",340,308,2,29,1,20,3,3,0,0,0,0,32,0,2,29,1,20,337,305,32
"N00001969",531,465,8,51,5,33,7,5,2,0,2,0,66,2,8,53,5,35,524,460,64
"N00001970",293,270,0,20,3,6,2,2,0,0,0,0,23,0,0,20,3,6,291,268,23
"N00001971",410,383,0,20,6,28,9,8,1,0,1,0,27,0,0,21,6,28,401,375,26
"N00001972",331,307,0,17,7,23,2,2,0,0,0,0,24,0,0,17,7,23,329,305,24
"N00001973",321,274,2,41,3,58,7,6,1,0,0,1,47,6,2,41,4,64,314,268,46
"N00001974",179,147,0,26,2,77,16,12,4,0,2,2,32,3,0,28,4,80,163,135,28
"N00001975",364,304,0,50,4,26,17,11,6,0,4,2,60,0,0,54,6,26,347,293,54
"N00001976",427,388,0,39,0,44,5,5,0,0,0,0,39,5,0,39,0,49,422,383,39
"N00001977",251,224,1,17,9,23,5,5,0,0,0,0,27,4,1,17,9,27,246,219,27
"N00001978",293,274,1,16,0,21,9,7,2,0,2,0,19,0,1,18,0,21,284,267,17
"N00001979",274,249,0,19,0,21,8,2,6,0,0,6,25,0,0,19,6,21,266,247,19
"N00001980",328,295,0,20,13,34,0,0,0,0,0,0,33,0,0,20,13,34,328,295,33
"N00001981",245,211,1,31,2,12,1,1,0,0,0,0,34,0,1,31,2,12,244,210,34
"N00001982",769,711,3,49,3,56,5,2,3,0,3,0,58,0,3,52,3,56,764,709,55
"N00001983",267,243,0,24,0,19,2,2,0,0,0,0,24,0,0,24,0,19,265,241,24
"N00001984",348,314,0,32,1,27,1,0,1,0,1,0,34,2,0,33,1,29,347,314,33
"N00001985",241,221,0,17,3,12,1,1,0,0,0,0,20,0,0,17,3,12,240,220,20
"N00001986",456,382,3,70,0,44,9,8,1,0,1,0,74,3,3,71,0,47,447,374,73
"N00001987",400,369,1,29,0,49,5,4,1,0,1,0,31,0,1,30,0,49,395,365,30
"N00001988",344,321,0,20,1,19,3,1,2,0,2,0,23,0,0,22,1,19,341,320,21
"N00001989",368,350,0,16,1,7,7,6,1,0,1,0,18,0,0,17,1,7,361,344,17
"N00001990",261,245,0,13,3,19,1,1,0,0,0,0,16,0,0,13,3,19,260,244,16
"N00001991",320,296,0,23,0,22,1,0,1,0,1,0,24,0,0,24,0,22,319,296,23
"N00001992",267,236,1,21,6,34,5,2,3,0,1,2,31,0,1,22,8,34,262,234,28
"N00001993",249,235,0,11,0,6,4,1,3,0,3,0,14,0,0,14,0,6,245,234,11
"N00001994",355,338,0,17,0,16,1,1,0,0,0,0,17,1,0,17,0,17,354,337,17
"N00001995",335,322,0,12,1,7,0,0,0,0,0,0,13,0,0,12,1,7,335,322,13
"N00001996",319,296,0,17,6,35,3,3,0,0,0,0,23,0,0,17,6,35,316,293,23
"N00001997",368,356,0,10,2,16,2,2,0,0,0,0,12,1,0,10,2,17,366,354,12
"N00001998",262,206,1,52,3,37,0,0,0,0,0,0,56,0,1,52,3,37,262,206,56
"N00001999",1298,890,36,350,19,160,18,15,3,0,3,0,408,4,36,353,19,164,1280,875,405
"N00002000",339,309,0,30,0,22,0,0,0,0,0,0,30,0,0,30,0,22,339,309,30
"N00002001",376,370,0,6,0,10,1,1,0,0,0,0,6,0,0,6,0,10,375,369,6
"N00002002",300,287,0,12,1,21,1,1,0,0,0,0,13,1,0,12,1,22,299,286,13
"N00002003",291,262,0,25,1,28,5,2,3,0,3,0,29,1,0,28,1,29,286,260,26
"N00002004",370,345,0,23,1,24,8,7,1,0,1,0,25,0,0,24,1,24,362,338,24
"N00002005",186,168,0,16,2,12,1,1,0,0,0,0,18,0,0,16,2,12,185,167,18
"N00002006",245,212,1,27,2,10,3,0,3,0,3,0,33,0,1,30,2,10,242,212,30
"N00002007",222,199,0,21,1,12,3,2,1,0,1,0,23,0,0,22,1,12,219,197,22
"N00002008",630,587,1,31,10,36,4,3,1,0,1,0,43,9,1,32,10,45,626,584,42
"N00002009",303,275,1,26,1,30,4,4,0,0,0,0,28,0,1,26,1,30,299,271,28
"N00002010",478,455,0,22,1,29,6,6,0,0,0,0,23,0,0,22,1,29,472,449,23
"N00002011",564,545,2,16,1,26,5,5,0,0,0,0,19,0,2,16,1,26,559,540,19
"N00002012",501,490,0,11,0,17,0,0,0,0,0,0,11,0,0,11,0,17,501,490,11
"N00002013",319,309,0,10,0,7,1,1,0,0,0,0,10,0,0,10,0,7,318,308,10
"N00002014",974,887,1,74,9,56,8,5,3,0,3,0,87,0,1,77,9,56,966,882,84
"N00002015",292,264,0,26,2,15,1,1,0,0,0,0,28,0,0,26,2,15,291,263,28
"N00002016",252,225,2,24,1,25,2,2,0,0,0,0,27,1,2,24,1,26,250,223,27
"N00002017",303,284,0,15,4,19,3,3,0,0,0,0,19,2,0,15,4,21,300,281,19
"N00002018",1387,1268,4,102,7,109,36,30,6,1,4,1,119,2,5,106,8,111,1351,1238,113
"N00002019",253,230,0,21,2,18,1,1,0,0,0,0,23,2,0,21,2,20,252,229,23
"N00002020",309,294,0,15,0,21,2,2,0,0,0,0,15,0,0,15,0,21,307,292,15
"N00002021",465,446,6,13,0,25,0,0,0,0,0,0,19,0,6,13,0,25,465,446,19
"N00002022",378,347,0,23,6,7,6,4,2,0,2,0,31,0,0,25,6,7,372,343,29
"N00002023",471,435,3,30,0,20,3,0,3,0,3,0,36,0,3,33,0,20,468,435,33
"N00002024",494,461,9,22,2,18,3,3,0,0,0,0,33,1,9,22,2,19,491,458,33
"N00002025",227,202,2,18,1,13,9,5,4,0,4,0,25,2,2,22,1,15,218,197,21
"N00002026",437,384,6,42,4,30,3,2,1,0,1,0,53,0,6,43,4,30,434,382,52
"N00002027",252,234,1,16,1,23,1,1,0,0,0,0,18,0,1,16,1,23,251,233,18
"N00002028",1232,1121,7,94,9,110,36,35,1,0,1,0,111,8,7,95,9,118,1196,1086,110
"N00002029",582,533,3,36,2,35,15,7,8,0,7,1,49,4,3,43,3,39,567,526,41
"N00002030",330,301,3,21,1,16,7,3,4,0,4,0,29,0,3,25,1,16,323,298,25
"N00002031",350,337,1,12,0,44,6,6,0,0,0,0,13,0,1,12,0,44,344,331,13
"N00002032",499,455,1,39,0,19,15,11,4,0,4,0,44,2,1,43,0,21,484,444,40
"N00002033",249,243,0,5,1,6,1,1,0,0,0,0,6,1,0,5,1,7,248,242,6
"N00002034",312,301,0,10,0,32,6,5,1,0,1,0,11,1,0,11,0,33,306,296,10
"N00002035",341,308,0,25,7,31,8,7,1,0,1,0,33,0,0,26,7,31,333,301,32
"N00002036",354,335,3,16,0,15,2,2,0,0,0,0,19,0,3,16,0,15,352,333,19
"N00002037",574,530,2,36,6,22,2,2,0,0,0,0,44,0,2,36,6,22,572,528,44
"N00002038",394,383,0,8,3,20,3,3,0,0,0,0,11,0,0,8,3,20,391,380,11
"N00002039",306,298,0,8,0,14,1,1,0,0,0,0,8,0,0,8,0,14,305,297,8
"N00002040",342,318,1,20,0,11,3,0,3,0,3,0,24,0,1,23,0,11,339,318,21
"N00002041",355,331,1,23,0,31,4,4,0,0,0,0,24,0,1,23,0,31,351,327,24
"N00002042",269,255,0,11,3,26,5,5,0,0,0,0,14,0,0,11,3,26,264,250,14
"N00002043",350,294,2,37,12,35,33,28,5,0,5,0,56,2,2,42,12,37,317,266,51
"N00002044",555,487,8,52,8,50,13,13,0,0,0,0,68,0,8,52,8,50,542,474,68
"N00002045",436,356,0,73,7,35,12,12,0,0,0,0,80,0,0,73,7,35,424,344,80
"N00002046",269,262,0,7,0,15,5,5,0,0,0,0,7,0,0,7,0,15,264,257,7
"N00002047",222,185,0,32,5,49,0,0,0,0,0,0,37,0,0,32,5,49,222,185,37
"N00002048",202,157,0,39,0,23,6,0,6,0,0,6,45,0,0,39,6,23,196,157,39
"N00002049",218,186,0,30,1,35,1,0,1,0,1,0,32,0,0,31,1,35,217,186,31
"N00002050",189,165,0,24,0,17,0,0,0,0,0,0,24,0,0,24,0,17,189,165,24
"N00002051",495,404,0,81,7,69,12,9,3,0,2,1,91,10,0,83,8,79,483,395,88
"N00002052",241,197,4,32,8,13,6,6,0,0,0,0,44,0,4,32,8,13,235,191,44
"N00002053",232,205,1,25,0,16,6,5,1,0,1,0,27,0,1,26,0,16,226,200,26
"N00002054",446,417,2,26,1,16,3,3,0,0,0,0,29,0,2,26,1,16,443,414,29
"N00002055",494,472,1,21,0,24,4,4,0,0,0,0,22,0,1,21,0,24,490,468,22
"N00002056",470,435,0,29,6,15,4,4,0,0,0,0,35,1,0,29,6,16,466,431,35
"N00002057",415,392,2,19,2,22,0,0,0,0,0,0,23,1,2,19,2,23,415,392,23
"N00002058",630,617,1,12,0,31,3,3,0,0,0,0,13,1,1,12,0,32,627,614,13
"N00002059",257,237,0,18,2,33,0,0,0,0,0,0,20,0,0,18,2,33,257,237,20
"N00002060",879,755,19,87,12,103,25,19,6,2,2,2,124,10,21,89,14,113,854,736,118
"N00002061",670,606,1,49,11,57,9,6,3,0,3,0,64,0,1,52,11,57,661,600,61
"N00002062",226,205,0,16,5,9,0,0,0,0,0,0,21,0,0,16,5,9,226,205,21
"N00002063",352,278,0,72,2,25,6,6,0,0,0,0,74,0,0,72,2,25,346,272,74
"N00002064",704,517,2,161,18,118,14,8,6,0,6,0,187,0,2,167,18,118,690,509,181
"N00002065",270,226,0,42,2,26,3,3,0,0,0,0,44,0,0,42,2,26,267,223,44
"N00002066",364,322,2,37,3,43,8,8,0,0,0,0,42,1,2,37,3,44,356,314,42
"N00002067",1004,550,26,399,24,173,13,8,5,0,4,1,454,2,26,403,25,175,991,542,449
"N00002068",248,205,0,40,1,15,3,1,2,0,0,2,43,0,0,40,3,15,245,204,41
"N00002069",435,394,0,41,0,32,2,2,0,0,0,0,41,0,0,41,0,32,433,392,41
"N00002070",1134,1045,2,77,0,67,15,5,10,0,4,6,89,1,2,81,6,68,1119,1040,79
"N00002071",320,303,0,17,0,23,1,1,0,0,0,0,17,2,0,17,0,25,319,302,17
"N00002072",284,268,0,15,1,16,0,0,0,0,0,0,16,0,0,15,1,16,284,268,16
"N00002073",262,253,0,9,0,13,5,5,0,0,0,0,9,0,0,9,0,13,257,248,9
"N00002074",840,809,2,29,0,55,12,12,0,0,0,0,31,0,2,29,0,55,828,797,31
"N00002075",362,342,0,20,0,10,0,0,0,0,0,0,20,0,0,20,0,10,362,342,20
"N00002076",226,209,0,17,0,10,1,1,0,0,0,0,17,0,0,17,0,10,225,208,17
"N00002077",229,218,0,11,0,10,0,0,0,0,0,0,11,0,0,11,0,10,229,218,11
"N00002078",266,249,0,16,0,24,3,2,1,0,1,0,17,0,0,17,0,24,263,247,16
"N00002079",654,590,0,49,5,50,34,24,10,0,3,7,64,7,0,52,12,57,620,566,54
"N00002080",321,290,2,28,0,19,4,3,1,0,1,0,31,0,2,29,0,19,317,287,30
"N00002081",282,254,2,24,2,14,7,7,0,0,0,0,28,0,2,24,2,14,275,247,28
"N00002082",1350,704,8,535,65,245,79,41,38,0,12,26,646,14,8,547,91,259,1271,663,608
"N00002083",323,316,0,7,0,34,0,0,0,0,0,0,7,8,0,7,0,42,323,316,7
"N00002084",438,408,1,21,2,20,20,14,6,0,5,1,30,0,1,26,3,20,418,394,24
"N00002085",603,563,0,34,2,42,22,18,4,0,4,0,40,10,0,38,2,52,581,545,36
"N00002086",482,457,0,17,5,27,15,12,3,0,3,0,25,1,0,20,5,28,467,445,22
"N00002087",238,198,3,24,12,44,8,7,1,0,1,0,40,0,3,25,12,44,230,191,39
"N00002088",336,318,0,17,0,37,11,10,1,0,1,0,18,0,0,18,0,37,325,308,17
"N00002089",374,368,0,6,0,20,1,1,0,0,0,0,6,0,0,6,0,20,373,367,6
"N00002090",484,466,0,17,1,21,1,1,0,0,0,0,18,0,0,17,1,21,483,465,18
"N00002091",980,948,1,27,2,28,6,4,2,0,0,2,32,0,1,27,4,28,974,944,30
"N00002092",517,498,10,9,0,7,0,0,0,0,0,0,19,0,10,9,0,7,517,498,19
"N00002093",597,585,3,9,0,21,0,0,0,0,0,0,12,0,3,9,0,21,597,585,12
"N00002094",695,647,3,40,5,43,2,2,0,0,0,0,48,0,3,40,5,43,693,645,48
"N00002095",485,477,0,7,1,17,1,1,0,0,0,0,8,0,0,7,1,17,484,476,8
"N00002096",454,418,2,33,1,38,1,1,0,0,0,0,36,0,2,33,1,38,453,417,36
"N00002097",395,380,2,13,0,24,3,3,0,0,0,0,15,0,2,13,0,24,392,377,15
"N00002098",397,386,0,10,1,24,0,0,0,0,0,0,11,0,0,10,1,24,397,386,11
"N00002099",454,440,0,10,3,19,1,0,1,0,1,0,14,0,0,11,3,19,453,440,13
"N00002100",505,477,1,24,3,9,3,3,0,0,0,0,28,0,1,24,3,9,502,474,28
"N00002101",551,531,2,17,1,18,0,0,0,0,0,0,20,0,2,17,1,18,551,531,20
"N00002102",450,441,0,9,0,18,1,1,0,0,0,0,9,0,0,9,0,18,449,440,9
"N00002103",804,733,0,65,2,65,17,13,4,0,4,0,71,0,0,69,2,65,787,720,67
"N00002104",280,258,0,19,3,16,1,1,0,0,0,0,22,0,0,19,3,16,279,257,22
"N00002105",417,374,1,32,9,17,5,4,1,0,1,0,43,0,1,33,9,17,412,370,42
"N00002106",327,303,0,16,8,37,1,1,0,0,0,0,24,0,0,16,8,37,326,302,24
"N00002107",538,494,2,37,1,48,17,13,4,0,3,1,44,2,2,40,2,50,521,481,40
"N00002108",421,402,0,16,2,16,2,1,1,0,0,1,19,0,0,16,3,16,419,401,18
"N00002109",524,492,3,29,0,23,1,1,0,0,0,0,32,5,3,29,0,28,523,491,32
"N00002110",530,511,5,12,2,33,0,0,0,0,0,0,19,0,5,12,2,33,530,511,19
"N00002111",563,540,0,20,3,22,12,12,0,0,0,0,23,0,0,20,3,22,551,528,23
"N00002112",468,454,1,12,1,10,0,0,0,0,0,0,14,0,1,12,1,10,468,454,14
"N00002113",531,507,0,22,1,32,4,3,1,0,1,0,24,0,0,23,1,32,527,504,23
"N00002114",366,350,0,14,1,20,3,2,1,0,1,0,16,0,0,15,1,20,363,348,15
"N00002115",249,226,1,19,3,19,0,0,0,0,0,0,23,0,1,19,3,19,249,226,23
"N00002116",263,234,4,22,0,20,3,0,3,0,0,3,29,0,4,22,3,20,260,234,26
"N00002117",323,306,0,17,0,25,3,3,0,0,0,0,17,3,0,17,0,28,320,303,17
"N00002118",406,370,1,30,5,32,1,1,0,0,0,0,36,1,1,30,5,33,405,369,36
"N00002119",278,267,0,8,3,10,1,1,0,0,0,0,11,0,0,8,3,10,277,266,11
"N00002120",261,241,0,15,3,23,2,0,2,0,0,2,20,0,0,15,5,23,259,241,18
"N00002121",454,443,1,9,1,12,0,0,0,0,0,0,11,0,1,9,1,12,454,443,11
"N00002122",523,501,0,21,1,18,0,0,0,0,0,0,22,0,0,21,1,18,523,501,22
"N00002123",461,446,0,12,3,14,0,0,0,0,0,0,15,0,0,12,3,14,461,446,15
"N00002124",346,326,2,11,7,19,0,0,0,0,0,0,20,1,2,11,7,20,346,326,20
"N00002125",1354,1244,6,94,5,97,18,13,5,0,5,0,110,1,6,99,5,98,1336,1231,105
"N00002126",480,441,1,35,1,36,6,4,2,0,0,2,39,0,1,35,3,36,474,437,37
"N00002127",812,714,13,76,1,45,9,1,8,0,1,7,98,0,13,77,8,45,803,713,90
"N00002128",763,677,2,59,14,95,39,28,11,3,1,7,86,2,5,60,21,97,724,649,75
"N00002129",1023,897,5,71,29,83,33,12,21,2,9,10,126,2,7,80,39,85,990,885,105
"N00002130",401,352,0,21,22,42,14,8,6,0,6,0,49,0,0,27,22,42,387,344,43
"N00002131",426,415,2,8,1,13,0,0,0,0,0,0,11,0,2,8,1,13,426,415,11
"N00002132",381,363,5,12,1,10,0,0,0,0,0,0,18,0,5,12,1,10,381,363,18
"N00002133",513,471,8,34,0,10,0,0,0,0,0,0,42,0,8,34,0,10,513,471,42
"N00002134",343,331,0,12,0,20,0,0,0,0,0,0,12,0,0,12,0,20,343,331,12
"N00002135",518,490,1,23,4,9,0,0,0,0,0,0,28,0,1,23,4,9,518,490,28
"N00002136",310,273,0,34,2,19,8,7,1,0,0,1,37,0,0,34,3,19,302,266,36
"N00002137",283,273,0,10,0,24,0,0,0,0,0,0,10,0,0,10,0,24,283,273,10
"N00002138",306,292,1,12,1,26,0,0,0,0,0,0,14,0,1,12,1,26,306,292,14
"N00002139",747,669,8,63,3,90,15,11,4,0,3,1,78,7,8,66,4,97,732,658,74
"N00002140",281,271,0,8,2,14,6,6,0,0,0,0,10,0,0,8,2,14,275,265,10
"N00002141",226,212,1,10,3,20,1,1,0,0,0,0,14,1,1,10,3,21,225,211,14
"N00002142",220,209,1,9,1,8,0,0,0,0,0,0,11,0,1,9,1,8,220,209,11
"N00002143",457,436,0,21,0,21,0,0,0,0,0,0,21,3,0,21,0,24,457,436,21
"N00002144",575,541,2,25,7,24,5,5,0,0,0,0,34,0,2,25,7,24,570,536,34
"N00002145",498,480,0,18,0,11,0,0,0,0,0,0,18,0,0,18,0,11,498,480,18
"N00002146",385,366,6,6,7,13,7,7,0,0,0,0,19,3,6,6,7,16,378,359,19
"N00002147",394,371,1,18,3,28,1,0,1,0,0,1,23,0,1,18,4,28,393,371,22
"N00002148",406,389,0,17,0,21,1,1,0,0,0,0,17,0,0,17,0,21,405,388,17
"N00002149",434,419,0,15,0,21,2,2,0,0,0,0,15,0,0,15,0,21,432,417,15
"N00002150",344,315,0,28,1,20,0,0,0,0,0,0,29,0,0,28,1,20,344,315,29
"N00002151",295,285,0,7,3,9,5,5,0,0,0,0,10,0,0,7,3,9,290,280,10
"N00002152",338,288,1,47,2,18,0,0,0,0,0,0,50,1,1,47,2,19,338,288,50
"N00002153",449,439,0,10,0,9,0,0,0,0,0,0,10,2,0,10,0,11,449,439,10
"N00002154",394,371,2,20,1,9,0,0,0,0,0,0,23,0,2,20,1,9,394,371,23
"N00002155",528,505,0,22,1,21,2,2,0,0,0,0,23,0,0,22,1,21,526,503,23
"N00002156",378,367,1,10,0,14,6,6,0,0,0,0,11,0,1,10,0,14,372,361,11
"N00002157",292,270,16,6,0,13,0,0,0,0,0,0,22,0,16,6,0,13,292,270,22
"N00002158",455,441,4,9,1,12,0,0,0,0,0,0,14,0,4,9,1,12,455,441,14
"N00002159",556,536,0,17,0,33,9,6,3,0,3,0,20,0,0,20,0,33,547,530,17
"N00002160",387,369,0,17,1,9,1,1,0,0,0,0,18,0,0,17,1,9,386,368,18
"N00002161",523,489,3,30,1,26,0,0,0,0,0,0,34,0,3,30,1,26,523,489,34
"N00002162",469,463,0,6,0,20,1,1,0,0,0,0,6,0,0,6,0,20,468,462,6
"N00002163",556,494,1,55,1,35,8,3,5,1,4,0,62,0,2,59,1,35,548,491,57
"N00002164",297,286,0,11,0,33,2,2,0,0,0,0,11,0,0,11,0,33,295,284,11
"N00002165",382,363,0,19,0,25,4,4,0,0,0,0,19,0,0,19,0,25,378,359,19
"N00002166",371,341,0,23,7,16,2,2,0,0,0,0,30,0,0,23,7,16,369,339,30
"N00002167",349,315,0,28,6,26,3,3,0,0,0,0,34,3,0,28,6,29,346,312,34
"N00002168",360,335,0,23,2,26,9,9,0,0,0,0,25,0,0,23,2,26,351,326,25
"N00002169",457,397,4,47,8,39,7,6,1,0,0,1,60,3,4,47,9,42,450,391,59
"N00002170",313,294,1,17,1,18,4,4,0,0,0,0,19,0,1,17,1,18,309,290,19
"N00002171",531,502,0,27,2,14,7,7,0,0,0,0,29,1,0,27,2,15,524,495,29
"N00002172",630,577,8,39,5,29,14,13,1,0,1,0,53,0,8,40,5,29,616,564,52
"N00002173",476,461,0,15,0,21,0,0,0,0,0,0,15,1,0,15,0,22,476,461,15
"N00002174",538,506,0,24,7,21,1,0,1,0,1,0,32,0,0,25,7,21,537,506,31
"N00002175",742,704,0,36,2,32,2,2,0,0,0,0,38,0,0,36,2,32,740,702,38
"N00002176",570,522,0,43,5,34,0,0,0,0,0,0,48,0,0,43,5,34,570,522,48
"N00002177",617,597,0,19,1,32,4,4,0,0,0,0,20,0,0,19,1,32,613,593,20
"N00002178",514,479,2,33,0,23,2,2,0,0,0,0,35,2,2,33,0,25,512,477,35
"N00002179",332,294,0,30,6,22,16,14,2,0,1,1,38,3,0,31,7,25,316,280,36
"N00002180",199,161,2,28,8,29,0,0,0,0,0,0,38,2,2,28,8,31,199,161,38
"N00002181",719,668,0,49,2,33,4,4,0,0,0,0,51,0,0,49,2,33,715,664,51
"N00002182",362,346,0,13,1,24,6,4,2,0,1,1,16,0,0,14,2,24,356,342,14
"N00002183",280,228,3,35,10,57,44,40,4,0,1,3,52,3,3,36,13,60,236,188,48
"N00002184",220,188,0,22,6,36,14,10,4,0,3,1,32,0,0,25,7,36,206,178,28
"N00002185",412,320,4,56,13,69,48,29,19,0,17,2,92,4,4,73,15,73,364,291,73
"N00002186",232,192,1,25,14,20,14,14,0,0,0,0,40,4,1,25,14,24,218,178,40
"N00002187",286,243,0,34,6,22,10,7,3,0,3,0,43,3,0,37,6,25,276,236,40
"N00002188",190,160,1,25,4,56,0,0,0,0,0,0,30,0,1,25,4,56,190,160,30
"N00002189",235,229,0,5,0,19,1,0,1,0,1,0,6,0,0,6,0,19,234,229,5
"N00002190",533,435,1,95,2,55,5,5,0,0,0,0,98,0,1,95,2,55,528,430,98
"N00002191",213,192,0,19,2,18,1,1,0,0,0,0,21,0,0,19,2,18,212,191,21
"N00002192",493,438,4,42,2,31,10,3,7,0,7,0,55,0,4,49,2,31,483,435,48
"N00002193",241,221,0,15,5,4,15,15,0,0,0,0,20,2,0,15,5,6,226,206,20
"N00002194",219,198,0,16,5,19,1,1,0,0,0,0,21,0,0,16,5,19,218,197,21
"N00002195",312,297,0,14,0,18,2,1,1,0,1,0,15,0,0,15,0,18,310,296,14
"N00002196",589,548,2,36,3,26,8,8,0,0,0,0,41,2,2,36,3,28,581,540,41
"N00002197",657,607,9,30,4,23,13,6,7,0,3,4,50,1,9,33,8,24,644,601,43
"N00002198",290,265,0,25,0,24,3,3,0,0,0,0,25,0,0,25,0,24,287,262,25
"N00002199",317,297,0,12,8,9,2,2,0,0,0,0,20,0,0,12,8,9,315,295,20
"N00002200",411,380,1,23,1,27,10,4,6,0,2,4,31,0,1,25,5,27,401,376,25
"N00002201",244,223,0,10,11,14,0,0,0,0,0,0,21,0,0,10,11,14,244,223,21
"N00002202",477,384,1,85,7,30,1,1,0,0,0,0,93,0,1,85,7,30,476,383,93
"N00002203",1147,1068,3,74,0,70,43,41,2,0,0,2,79,2,3,74,2,72,1104,1027,77
"N00002204",431,413,1,16,0,17,4,3,1,0,0,1,18,0,1,16,1,17,427,410,17
"N00002205",805,758,4,38,2,43,31,28,3,0,3,0,47,11,4,41,2,54,774,730,44
"N00002206",325,300,0,25,0,12,1,1,0,0,0,0,25,0,0,25,0,12,324,299,25
"N00002207",299,296,0,3,0,10,6,6,0,0,0,0,3,21,0,3,0,31,293,290,3
"N00002208",334,327,0,5,0,20,38,36,2,1,0,1,7,1,1,5,1,21,296,291,5
"N00002209",361,347,0,8,0,14,18,12,6,0,6,0,14,0,0,14,0,14,343,335,8
"N00002210",417,395,4,17,1,34,3,3,0,0,0,0,22,0,4,17,1,34,414,392,22
"N00002211",247,228,0,19,0,15,0,0,0,0,0,0,19,0,0,19,0,15,247,228,19
"N00002212",259,238,0,17,4,22,4,4,0,0,0,0,21,0,0,17,4,22,255,234,21
"N00002213",790,654,5,110,18,72,33,30,3,0,3,0,136,0,5,113,18,72,757,624,133
"N00002214",358,334,0,24,0,55,3,3,0,0,0,0,24,0,0,24,0,55,355,331,24
"N00002215",271,260,0,11,0,19,0,0,0,0,0,0,11,0,0,11,0,19,271,260,11
"N00002216",269,255,1,9,0,27,6,2,4,0,4,0,14,0,1,13,0,27,263,253,10
"N00002217",235,203,0,28,3,29,2,1,1,0,1,0,32,0,0,29,3,29,233,202,31
"N00002218",235,210,0,23,2,16,1,1,0,0,0,0,25,1,0,23,2,17,234,209,25
"N00002219",224,216,0,8,0,16,2,2,0,0,0,0,8,1,0,8,0,17,222,214,8
"N00002220",484,429,1,44,10,45,7,7,0,0,0,0,55,0,1,44,10,45,477,422,55
"N00002221",448,403,6,37,2,36,4,4,0,0,0,0,45,0,6,37,2,36,444,399,45
"N00002222",282,250,5,26,0,19,11,10,1,0,1,0,32,0,5,27,0,19,271,240,31
"N00002223",138,131,0,7,0,8,9,9,0,0,0,0,7,3,0,7,0,11,129,122,7
"N00002224",198,171,0,19,7,17,6,5,1,0,0,1,27,0,0,19,8,17,192,166,26
"N00002225",331,299,2,27,3,25,3,3,0,0,0,0,32,0,2,27,3,25,328,296,32
"N00002226",225,201,0,17,7,18,1,1,0,0,0,0,24,0,0,17,7,18,224,200,24
"N00002227",249,228,4,16,0,15,6,5,1,0,0,1,21,0,4,16,1,15,243,223,20
"N00002228",260,243,0,8,9,17,0,0,0,0,0,0,17,0,0,8,9,17,260,243,17
"N00002229",1012,940,2,43,19,44,39,31,8,0,8,0,72,1,2,51,19,45,973,909,64
"N00002230",289,273,1,10,5,11,19,19,0,0,0,0,16,1,1,10,5,12,270,254,16
"N00002231",348,319,1,21,6,30,11,10,1,0,1,0,29,1,1,22,6,31,337,309,28
"N00002232",799,673,9,69,24,74,71,47,24,1,10,13,126,12,10,79,37,86,728,626,102
"N00002233",312,270,1,20,13,25,35,27,8,1,6,1,42,9,2,26,14,34,277,243,34
"N00002234",246,216,0,19,9,35,11,9,2,0,1,1,30,0,0,20,10,35,235,207,28
"N00002235",314,288,1,18,6,32,11,10,1,1,0,0,26,0,2,18,6,32,303,278,25
"N00002236",611,536,1,70,3,60,3,2,1,0,0,1,75,1,1,70,4,61,608,534,74
"N00002237",340,302,0,32,6,11,2,2,0,0,0,0,38,1,0,32,6,12,338,300,38
"N00002238",274,249,0,21,4,40,3,3,0,0,0,0,25,1,0,21,4,41,271,246,25
"N00002239",242,214,0,26,2,14,3,3,0,0,0,0,28,0,0,26,2,14,239,211,28
"N00002240",329,285,0,39,0,22,7,2,5,0,0,5,44,0,0,39,5,22,322,283,39
"N00002241",323,272,4,41,5,49,3,2,1,0,1,0,51,0,4,42,5,49,320,270,50
"N00002242",276,250,0,16,5,29,13,8,5,0,5,0,26,0,0,21,5,29,263,242,21
"N00002243",242,220,0,17,0,36,8,3,5,0,5,0,22,0,0,22,0,36,234,217,17
"N00002244",299,289,0,9,1,31,1,1,0,0,0,0,10,0,0,9,1,31,298,288,10
"N00002245",214,190,0,24,0,22,1,1,0,0,0,0,24,2,0,24,0,24,213,189,24
"N00002246",467,440,1,23,3,22,2,2,0,0,0,0,27,0,1,23,3,22,465,438,27
"N00002247",471,444,3,23,0,18,4,3,1,0,1,0,27,0,3,24,0,18,467,441,26
"N00002248",778,742,2,26,8,45,5,5,0,0,0,0,36,0,2,26,8,45,773,737,36
"N00002249",613,568,0,44,1,52,1,1,0,0,0,0,45,0,0,44,1,52,612,567,45
"N00002250",351,341,0,10,0,17,1,1,0,0,0,0,10,0,0,10,0,17,350,340,10
"N00002251",394,376,0,15,3,10,3,3,0,0,0,0,18,0,0,15,3,10,391,373,18
"N00002252",895,859,0,31,5,62,1,1,0,0,0,0,36,0,0,31,5,62,894,858,36
"N00002253",418,411,0,3,2,19,2,0,2,0,2,0,7,0,0,5,2,19,416,411,5
"N00002254",545,473,1,58,13,55,2,2,0,0,0,0,72,0,1,58,13,55,543,471,72
"N00002255",543,531,0,12,0,23,0,0,0,0,0,0,12,1,0,12,0,24,543,531,12
"N00002256",499,469,0,19,6,28,13,8,5,0,3,2,30,0,0,22,8,28,486,461,25
"N00002257",342,329,1,11,0,20,2,1,1,0,1,0,13,0,1,12,0,20,340,328,12
"N00002258",344,310,0,34,0,14,8,8,0,0,0,0,34,1,0,34,0,15,336,302,34
"N00002259",353,320,0,29,3,36,4,3,1,0,1,0,33,2,0,30,3,38,349,317,32
"N00002260",797,744,12,34,7,44,8,8,0,0,0,0,53,0,12,34,7,44,789,736,53
"N00002261",723,655,3,60,5,45,4,4,0,0,0,0,68,4,3,60,5,49,719,651,68
"N00002262",444,423,1,17,2,18,8,7,1,0,0,1,21,0,1,17,3,18,436,416,20
"N00002263",487,460,0,25,2,17,7,7,0,0,0,0,27,0,0,25,2,17,480,453,27
"N00002264",732,667,1,48,16,53,13,13,0,0,0,0,65,8,1,48,16,61,719,654,65
"N00002265",618,536,4,71,3,75,18,14,4,0,2,2,82,1,4,73,5,76,600,522,78
"N00002266",290,272,1,16,1,23,1,1,0,0,0,0,18,0,1,16,1,23,289,271,18
"N00002267",486,439,3,36,7,31,31,30,1,0,1,0,47,3,3,37,7,34,455,409,46
"N00002268",803,705,1,80,12,74,21,16,5,0,5,0,98,0,1,85,12,74,782,689,93
"N00002269",326,299,0,26,0,30,7,6,1,0,1,0,27,1,0,27,0,31,319,293,26
"N00002270",352,317,0,30,4,49,5,4,1,0,1,0,35,2,0,31,4,51,347,313,34
"N00002271",333,301,0,30,0,40,9,7,2,0,2,0,32,0,0,32,0,40,324,294,30
"N00002272",272,257,1,13,1,13,9,9,0,0,0,0,15,0,1,13,1,13,263,248,15
"N00002273",597,533,3,36,22,42,41,38,3,0,2,1,64,4,3,38,23,46,556,495,61
"N00002274",251,224,6,13,8,11,8,8,0,0,0,0,27,1,6,13,8,12,243,216,27
"N00002275",254,228,4,14,7,28,8,7,1,0,0,1,26,0,4,14,8,28,246,221,25
"N00002276",299,281,0,14,4,28,7,7,0,0,0,0,18,2,0,14,4,30,292,274,18
"N00002277",515,452,1,54,5,41,6,3,3,0,0,3,63,0,1,54,8,41,509,449,60
"N00002278",336,314,1,14,2,18,10,5,5,0,5,0,22,0,1,19,2,18,326,309,17
"N00002279",205,204,0,1,0,18,2,2,0,0,0,0,1,0,0,1,0,18,203,202,1
"N00002280",288,256,0,20,10,25,3,1,2,0,1,1,32,0,0,21,11,25,285,255,30
"N00002281",420,388,1,26,5,50,12,12,0,0,0,0,32,1,1,26,5,51,408,376,32
"N00002282",276,245,0,24,1,30,7,1,6,0,4,2,31,0,0,28,3,30,269,244,25
"N00002283",277,266,1,5,5,12,4,4,0,0,0,0,11,0,1,5,5,12,273,262,11
"N00002284",297,274,0,20,0,23,6,3,3,0,3,0,23,0,0,23,0,23,291,271,20
"N00002285",420,404,0,14,1,34,7,6,1,0,1,0,16,0,0,15,1,34,413,398,15
"N00002286",359,346,1,12,0,21,0,0,0,0,0,0,13,0,1,12,0,21,359,346,13
"N00002287",308,290,0,13,4,22,1,0,1,0,1,0,18,0,0,14,4,22,307,290,17
"N00002288",294,288,0,6,0,13,0,0,0,0,0,0,6,0,0,6,0,13,294,288,6
"N00002289",242,217,0,24,1,13,10,10,0,0,0,0,25,0,0,24,1,13,232,207,25
"N00002290",456,418,0,27,8,28,19,16,3,0,2,1,38,5,0,29,9,33,437,402,35
"N00002291",442,384,1,35,11,57,19,8,11,0,7,4,58,10,1,42,15,67,423,376,47
"N00002292",309,293,0,14,2,23,0,0,0,0,0,0,16,0,0,14,2,23,309,293,16
"N00002293",231,207,0,19,4,19,7,6,1,0,0,1,24,0,0,19,5,19,224,201,23
"N00002294",292,282,0,9,1,17,2,2,0,0,0,0,10,0,0,9,1,17,290,280,10
"N00002295",334,299,0,31,1,13,16,13,3,0,3,0,35,1,0,34,1,14,318,286,32
"N00002296",407,359,0,43,4,27,12,11,1,0,1,0,48,2,0,44,4,29,395,348,47
"N00002297",335,320,0,12,1,17,10,8,2,0,2,0,15,1,0,14,1,18,325,312,13
"N00002298",277,256,0,17,1,17,14,11,3,0,3,0,21,1,0,20,1,18,263,245,18
"N00002299",372,347,0,20,0,28,11,6,5,0,2,3,25,5,0,22,3,33,361,341,20
"N00002300",813,725,1,83,1,42,17,14,3,0,3,0,88,11,1,86,1,53,796,711,85
"N00002301",671,633,2,29,4,32,47,44,3,0,3,0,38,3,2,32,4,35,624,589,35
"N00002302",658,620,4,32,2,34,26,26,0,0,0,0,38,1,4,32,2,35,632,594,38
"N00002303",447,408,3,29,2,32,30,25,5,0,4,1,39,0,3,33,3,32,417,383,34
"N00002304",218,193,0,21,4,20,12,12,0,0,0,0,25,0,0,21,4,20,206,181,25
"N00002305",790,712,8,52,11,50,44,37,7,0,5,2,78,4,8,57,13,54,746,675,71
"N00002306",1483,1236,13,158,50,112,78,52,26,0,18,8,247,6,13,176,58,118,1405,1184,221
"N00002307",378,363,0,13,1,17,9,8,1,0,1,0,15,0,0,14,1,17,369,355,14
"N00002308",329,319,0,10,0,14,12,12,0,0,0,0,10,0,0,10,0,14,317,307,10
"N00002309",224,194,0,22,8,43,3,3,0,0,0,0,30,0,0,22,8,43,221,191,30
"N00002310",218,205,0,9,3,10,2,1,1,0,1,0,13,0,0,10,3,10,216,204,12
"N00002311",285,261,0,21,1,36,23,21,2,0,2,0,24,0,0,23,1,36,262,240,22
"N00002312",309,283,2,17,2,35,26,21,5,0,5,0,26,2,2,22,2,37,283,262,21
"N00002313",302,274,2,24,1,18,14,13,1,0,1,0,28,7,2,25,1,25,288,261,27
"N00002314",274,253,0,15,3,14,4,1,3,0,3,0,21,1,0,18,3,15,270,252,18
"N00002315",344,316,1,24,1,22,19,17,2,0,2,0,28,1,1,26,1,23,325,299,26
"N00002316",254,228,0,24,0,15,9,7,2,0,2,0,26,0,0,26,0,15,245,221,24
"N00002317",304,286,0,13,5,9,0,0,0,0,0,0,18,0,0,13,5,9,304,286,18
"N00002318",383,347,1,35,0,18,5,5,0,0,0,0,36,0,1,35,0,18,378,342,36
"N00002319",698,634,4,53,2,40,11,6,5,0,0,5,64,0,4,53,7,40,687,628,59
"N00002320",299,264,0,33,2,35,4,4,0,0,0,0,35,3,0,33,2,38,295,260,35
"N00002321",290,283,0,7,0,17,4,4,0,0,0,0,7,1,0,7,0,18,286,279,7
"N00002322",302,282,0,17,1,25,3,1,2,0,2,0,20,0,0,19,1,25,299,281,18
"N00002323",331,312,0,19,0,19,2,2,0,0,0,0,19,0,0,19,0,19,329,310,19
"N00002324",291,272,0,18,1,19,0,0,0,0,0,0,19,1,0,18,1,20,291,272,19
"N00002325",453,411,0,41,1,26,0,0,0,0,0,0,42,0,0,41,1,26,453,411,42
"N00002326",307,293,0,14,0,8,1,1,0,0,0,0,14,1,0,14,0,9,306,292,14
"N00002327",1297,1205,0,75,9,44,25,17,8,0,7,1,92,2,0,82,10,46,1272,1188,84
"N00002328",363,355,0,8,0,32,7,7,0,0,0,0,8,1,0,8,0,33,356,348,8
"N00002329",316,290,0,26,0,37,7,7,0,0,0,0,26,0,0,26,0,37,309,283,26
"N00002330",619,584,5,30,0,42,9,9,0,0,0,0,35,1,5,30,0,43,610,575,35
"N00002331",606,580,0,22,4,31,4,4,0,0,0,0,26,0,0,22,4,31,602,576,26
"N00002332",360,337,0,22,0,21,3,2,1,0,1,0,23,0,0,23,0,21,357,335,22
"N00002333",395,380,0,12,1,22,2,0,2,0,2,0,15,0,0,14,1,22,393,380,13
"N00002334",345,330,0,15,0,43,2,2,0,0,0,0,15,0,0,15,0,43,343,328,15
"N00002335",540,514,0,26,0,63,10,10,0,0,0,0,26,0,0,26,0,63,530,504,26
"N00002336",322,300,0,22,0,37,0,0,0,0,0,0,22,0,0,22,0,37,322,300,22
"N00002337",355,325,0,27,3,26,1,1,0,0,0,0,30,2,0,27,3,28,354,324,30
"N00002338",263,239,0,24,0,17,0,0,0,0,0,0,24,0,0,24,0,17,263,239,24
"N00002339",296,279,0,17,0,9,1,1,0,0,0,0,17,0,0,17,0,9,295,278,17
"N00002340",295,276,1,18,0,16,2,2,0,0,0,0,19,0,1,18,0,16,293,274,19
"N00002341",236,208,0,28,0,29,0,0,0,0,0,0,28,0,0,28,0,29,236,208,28
"N00002342",284,266,1,17,0,26,0,0,0,0,0,0,18,0,1,17,0,26,284,266,18
"N00002343",350,326,0,23,0,18,4,3,1,0,1,0,24,2,0,24,0,20,346,323,23
"N00002344",378,323,0,43,10,40,11,9,2,0,0,2,55,1,0,43,12,41,367,314,53
"N00002345",300,258,4,32,1,13,7,2,5,0,3,2,42,0,4,35,3,13,293,256,37
"N00002346",235,209,1,14,11,7,5,5,0,0,0,0,26,1,1,14,11,8,230,204,26
"N00002347",678,595,4,75,4,83,12,12,0,0,0,0,83,0,4,75,4,83,666,583,83
"N00002348",338,302,3,31,0,35,15,13,2,0,2,0,36,0,3,33,0,35,323,289,34
"N00002349",250,224,0,22,2,22,10,8,2,0,0,2,26,0,0,22,4,22,240,216,24
"N00002350",180,172,0,6,1,14,1,0,1,0,0,1,8,0,0,6,2,14,179,172,7
"N00002351",1332,1221,15,89,3,60,14,10,4,0,4,0,111,0,15,93,3,60,1318,1211,107
"N00002352",292,278,0,14,0,14,6,6,0,0,0,0,14,0,0,14,0,14,286,272,14
"N00002353",1824,1668,14,124,7,117,46,35,11,3,7,1,156,5,17,131,8,122,1778,1633,145
"N00002354",378,359,1,15,1,39,6,4,2,0,2,0,19,0,1,17,1,39,372,355,17
"N00002355",278,255,0,20,1,12,3,1,2,0,1,1,23,5,0,21,2,17,275,254,21
"N00002356",409,388,1,20,0,21,15,15,0,0,0,0,21,1,1,20,0,22,394,373,21
"N00002357",348,317,0,29,0,33,9,7,2,0,2,0,31,8,0,31,0,41,339,310,29
"N00002358",236,217,0,19,0,29,2,2,0,0,0,0,19,1,0,19,0,30,234,215,19
"N00002359",255,237,0,18,0,17,1,1,0,0,0,0,18,1,0,18,0,18,254,236,18
"N00002360",234,204,1,29,0,40,3,3,0,0,0,0,30,0,1,29,0,40,231,201,30
"N00002361",295,277,0,12,3,26,9,6,3,0,1,2,18,0,0,13,5,26,286,271,15
"N00002362",242,223,0,14,4,18,6,5,1,0,0,1,19,0,0,14,5,18,236,218,18
"N00002363",231,202,3,21,5,17,2,2,0,0,0,0,29,0,3,21,5,17,229,200,29
"N00002364",212,179,0,32,1,27,2,2,0,0,0,0,33,1,0,32,1,28,210,177,33
"N00002365",287,275,0,9,0,25,5,2,3,0,3,0,12,0,0,12,0,25,282,273,9
"N00002366",272,254,0,17,1,21,2,2,0,0,0,0,18,0,0,17,1,21,270,252,18
"N00002367",384,358,2,19,4,38,2,1,1,0,1,0,26,6,2,20,4,44,382,357,25
"N00002368",437,426,0,11,0,32,0,0,0,0,0,0,11,0,0,11,0,32,437,426,11
"N00002369",740,642,3,82,7,56,11,5,6,0,1,5,98,5,3,83,12,61,729,637,92
"N00002370",387,359,0,28,0,26,0,0,0,0,0,0,28,0,0,28,0,26,387,359,28
"N00002371",463,439,0,23,1,21,7,7,0,0,0,0,24,0,0,23,1,21,456,432,24
"N00002372",613,578,0,34,1,36,3,3,0,0,0,0,35,0,0,34,1,36,610,575,35
"N00002373",436,407,0,22,6,24,4,3,1,0,1,0,29,10,0,23,6,34,432,404,28
"N00002374",300,281,0,16,1,17,7,5,2,0,2,0,19,1,0,18,1,18,293,276,17
"N00002375",393,348,0,42,2,39,1,0,1,0,1,0,45,0,0,43,2,39,392,348,44
"N00002376",436,418,0,18,0,21,1,1,0,0,0,0,18,0,0,18,0,21,435,417,18
"N00002377",433,397,0,36,0,52,1,1,0,0,0,0,36,0,0,36,0,52,432,396,36
"N00002378",749,667,3,74,4,36,12,11,1,0,0,1,82,0,3,74,5,36,737,656,81
"N00002379",667,588,0,72,5,54,8,6,2,0,2,0,79,0,0,74,5,54,659,582,77
"N00002380",298,286,0,12,0,15,0,0,0,0,0,0,12,0,0,12,0,15,298,286,12
"N00002381",386,350,0,33,3,29,3,3,0,0,0,0,36,0,0,33,3,29,383,347,36
"N00002382",458,428,0,19,6,33,6,1,5,0,5,0,30,0,0,24,6,33,452,427,25
"N00002383",454,429,0,18,4,35,10,7,3,0,3,0,25,0,0,21,4,35,444,422,22
"N00002384",377,352,4,20,0,40,5,4,1,0,1,0,25,0,4,21,0,40,372,348,24
"N00002385",278,263,0,15,0,26,5,5,0,0,0,0,15,0,0,15,0,26,273,258,15
"N00002386",265,240,2,20,3,21,0,0,0,0,0,0,25,1,2,20,3,22,265,240,25
"N00002387",451,397,2,49,2,60,5,4,1,0,1,0,54,0,2,50,2,60,446,393,53
"N00002388",199,173,0,18,4,26,5,1,4,0,4,0,26,0,0,22,4,26,194,172,22
"N00002389",311,274,0,29,7,27,17,16,1,0,0,1,37,0,0,29,8,27,294,258,36
"N00002390",293,241,2,39,9,21,4,2,2,0,2,0,52,0,2,41,9,21,289,239,50
"N00002391",402,377,0,24,1,22,0,0,0,0,0,0,25,3,0,24,1,25,402,377,25
"N00002392",349,324,0,24,1,19,1,1,0,0,0,0,25,0,0,24,1,19,348,323,25
"N00002393",653,624,3,26,0,25,9,9,0,0,0,0,29,0,3,26,0,25,644,615,29
"N00002394",363,327,0,32,4,27,3,3,0,0,0,0,36,6,0,32,4,33,360,324,36
"N00002395",412,404,0,8,0,21,0,0,0,0,0,0,8,0,0,8,0,21,412,404,8
"N00002396",288,270,0,18,0,11,0,0,0,0,0,0,18,0,0,18,0,11,288,270,18
"N00002397",333,298,4,26,1,26,6,2,4,0,3,1,35,0,4,29,2,26,327,296,31
"N00002398",366,349,5,12,0,18,2,2,0,0,0,0,17,0,5,12,0,18,364,347,17
"N00002399",266,236,1,24,0,17,8,3,5,0,1,4,30,1,1,25,4,18,258,233,25
"N00002400",218,202,0,15,1,16,0,0,0,0,0,0,16,0,0,15,1,16,218,202,16
"N00002401",1544,1345,6,153,16,136,89,65,24,10,10,4,199,35,16,163,20,171,1455,1280,175
"N00002402",233,211,0,22,0,10,4,4,0,0,0,0,22,0,0,22,0,10,229,207,22
"N00002403",400,361,3,33,2,73,6,5,1,0,1,0,39,1,3,34,2,74,394,356,38
"N00002404",882,816,7,49,4,58,21,15,6,0,2,4,66,0,7,51,8,58,861,801,60
"N00002405",332,302,0,24,5,20,6,5,1,0,0,1,30,0,0,24,6,20,326,297,29
"N00002406",304,283,1,14,6,21,3,3,0,0,0,0,21,0,1,14,6,21,301,280,21
"N00002407",263,251,0,10,2,38,2,2,0,0,0,0,12,0,0,10,2,38,261,249,12
"N00002408",388,371,0,17,0,51,3,3,0,0,0,0,17,0,0,17,0,51,385,368,17
"N00002409",319,290,0,24,5,20,5,5,0,0,0,0,29,2,0,24,5,22,314,285,29
"N00002410",285,273,0,12,0,5,3,3,0,0,0,0,12,0,0,12,0,5,282,270,12
"N00002411",339,329,0,10,0,20,10,10,0,0,0,0,10,0,0,10,0,20,329,319,10
"N00002412",388,381,0,5,2,42,12,12,0,0,0,0,7,0,0,5,2,42,376,369,7
"N00002413",403,381,0,21,1,23,10,10,0,0,0,0,22,0,0,21,1,23,393,371,22
"N00002414",279,256,0,21,1,24,1,0,1,0,1,0,23,3,0,22,1,27,278,256,22
"N00002415",276,263,0,10,3,11,1,1,0,0,0,0,13,6,0,10,3,17,275,262,13
"N00002416",515,486,1,22,6,22,0,0,0,0,0,0,29,0,1,22,6,22,515,486,29
"N00002417",355,341,0,13,1,16,0,0,0,0,0,0,14,1,0,13,1,17,355,341,14
"N00002418",570,553,0,17,0,27,7,7,0,0,0,0,17,1,0,17,0,28,563,546,17
"N00002419",652,593,3,53,3,40,2,2,0,0,0,0,59,0,3,53,3,40,650,591,59
"N00002420",507,491,1,12,2,19,3,2,1,0,1,0,16,0,1,13,2,19,504,489,15
"N00002421",427,412,3,9,3,10,5,5,0,0,0,0,15,0,3,9,3,10,422,407,15
"N00002422",482,458,0,21,3,15,3,3,0,0,0,0,24,0,0,21,3,15,479,455,24
"N00002423",209,194,0,14,1,14,1,1,0,0,0,0,15,0,0,14,1,14,208,193,15
"N00002424",328,300,3,24,1,33,0,0,0,0,0,0,28,1,3,24,1,34,328,300,28
"N00002425",296,275,1,20,0,18,0,0,0,0,0,0,21,1,1,20,0,19,296,275,21
"N00002426",338,311,0,19,3,22,6,1,5,0,1,4,27,1,0,20,7,23,332,310,22
"N00002427",351,337,0,9,4,26,3,2,1,0,1,0,14,1,0,10,4,27,348,335,13
"N00002428",325,299,0,24,2,7,0,0,0,0,0,0,26,1,0,24,2,8,325,299,26
"N00002429",304,289,0,14,1,18,1,1,0,0,0,0,15,0,0,14,1,18,303,288,15
"N00002430",318,298,3,15,1,16,9,8,1,0,0,1,20,0,3,15,2,16,309,290,19
"N00002431",999,935,8,52,2,79,4,2,2,0,0,2,64,2,8,52,4,81,995,933,62
"N00002432",258,236,1,21,0,22,1,1,0,0,0,0,22,0,1,21,0,22,257,235,22
"N00002433",377,357,0,18,2,47,0,0,0,0,0,0,20,0,0,18,2,47,377,357,20
"N00002434",266,223,0,38,5,4,3,3,0,0,0,0,43,2,0,38,5,6,263,220,43
"N00002435",277,261,0,14,2,14,2,2,0,0,0,0,16,0,0,14,2,14,275,259,16
"N00002436",417,407,0,10,0,22,5,5,0,0,0,0,10,0,0,10,0,22,412,402,10
"N00002437",291,279,0,10,2,21,0,0,0,0,0,0,12,0,0,10,2,21,291,279,12
"N00002438",354,338,4,11,1,26,2,2,0,0,0,0,16,1,4,11,1,27,352,336,16
"N00002439",314,303,2,8,1,21,2,2,0,0,0,0,11,0,2,8,1,21,312,301,11
"N00002440",306,294,0,8,4,32,4,4,0,0,0,0,12,0,0,8,4,32,302,290,12
"N00002441",236,229,2,5,0,10,4,4,0,0,0,0,7,0,2,5,0,10,232,225,7
"N00002442",337,299,0,37,1,28,2,2,0,0,0,0,38,0,0,37,1,28,335,297,38
"N00002443",348,334,0,14,0,25,4,4,0,0,0,0,14,0,0,14,0,25,344,330,14
"N00002444",812,750,2,57,2,46,5,4,1,0,0,1,62,1,2,57,3,47,807,746,61
"N00002445",307,283,0,13,8,10,10,7,3,0,3,0,24,0,0,16,8,10,297,276,21
"N00002446",254,233,1,19,0,18,4,3,1,0,0,1,21,2,1,19,1,20,250,230,20
"N00002447",326,306,0,17,1,23,3,1,2,0,2,0,20,0,0,19,1,23,323,305,18
"N00002448",326,301,4,21,0,23,3,3,0,0,0,0,25,0,4,21,0,23,323,298,25
"N00002449",289,271,0,18,0,18,3,3,0,0,0,0,18,0,0,18,0,18,286,268,18
"N00002450",287,274,0,13,0,15,3,3,0,0,0,0,13,1,0,13,0,16,284,271,13
"N00002451",620,581,4,32,1,19,3,1,2,0,2,0,39,0,4,34,1,19,617,580,37
"N00002452",307,297,0,10,0,10,0,0,0,0,0,0,10,0,0,10,0,10,307,297,10
"N00002453",364,347,0,15,2,24,2,2,0,0,0,0,17,0,0,15,2,24,362,345,17
"N00002454",354,327,1,26,0,21,2,2,0,0,0,0,27,0,1,26,0,21,352,325,27
"N00002455",383,368,0,10,4,12,6,5,1,0,1,0,15,0,0,11,4,12,377,363,14
"N00002456",381,357,0,22,2,18,7,7,0,0,0,0,24,1,0,22,2,19,374,350,24
"N00002457",538,494,0,44,0,52,4,4,0,0,0,0,44,0,0,44,0,52,534,490,44
"N00002458",299,286,4,9,0,13,4,4,0,0,0,0,13,2,4,9,0,15,295,282,13
"N00002459",830,796,4,24,2,35,11,7,4,0,3,1,34,1,4,27,3,36,819,789,30
"N00002460",459,435,3,20,1,25,3,3,0,0,0,0,24,0,3,20,1,25,456,432,24
"N00002461",596,590,0,5,1,25,1,1,0,0,0,0,6,0,0,5,1,25,595,589,6
"N00002462",536,508,0,27,1,20,0,0,0,0,0,0,28,0,0,27,1,20,536,508,28
"N00002463",431,422,0,8,1,27,1,1,0,0,0,0,9,0,0,8,1,27,430,421,9
"N00002464",411,385,0,23,0,13,7,4,3,0,3,0,26,0,0,26,0,13,404,381,23
"N00002465",850,817,1,31,0,35,3,2,1,0,1,0,33,0,1,32,0,35,847,815,32
"N00002466",302,287,2,11,2,13,1,1,0,0,0,0,15,1,2,11,2,14,301,286,15
"N00002467",304,298,2,3,1,31,0,0,0,0,0,0,6,0,2,3,1,31,304,298,6
"N00002468",280,269,0,11,0,17,0,0,0,0,0,0,11,0,0,11,0,17,280,269,11
"N00002469",620,593,0,25,0,42,6,4,2,0,1,1,27,0,0,26,1,42,614,589,25
"N00002470",394,380,0,13,1,27,1,1,0,0,0,0,14,0,0,13,1,27,393,379,14
"N00002471",322,306,3,12,1,14,0,0,0,0,0,0,16,0,3,12,1,14,322,306,16
"N00002472",478,440,0,38,0,16,2,2,0,0,0,0,38,0,0,38,0,16,476,438,38
"N00002473",331,322,0,8,1,16,0,0,0,0,0,0,9,0,0,8,1,16,331,322,9
"N00002474",373,349,1,15,8,29,0,0,0,0,0,0,24,0,1,15,8,29,373,349,24
"N00002475",386,373,0,12,1,7,2,2,0,0,0,0,13,0,0,12,1,7,384,371,13
"N00002476",387,369,0,16,1,21,3,2,1,0,0,1,18,0,0,16,2,21,384,367,17
"N00002477",312,289,1,21,0,27,7,6,1,0,1,0,23,0,1,22,0,27,305,283,22
"N00002478",570,536,1,32,1,7,15,15,0,0,0,0,34,1,1,32,1,8,555,521,34
"N00002479",481,465,0,16,0,39,3,3,0,0,0,0,16,0,0,16,0,39,478,462,16
"N00002480",659,628,1,28,2,29,4,4,0,0,0,0,31,0,1,28,2,29,655,624,31
"N00002481",330,312,0,16,1,35,3,2,1,0,1,0,18,0,0,17,1,35,327,310,17
"N00002482",314,298,1,15,0,14,3,3,0,0,0,0,16,0,1,15,0,14,311,295,16
"N00002483",332,319,0,10,3,10,4,4,0,0,0,0,13,0,0,10,3,10,328,315,13
"N00002484",322,290,1,31,0,19,1,1,0,0,0,0,32,0,1,31,0,19,321,289,32
"N00002485",285,258,0,26,1,18,0,0,0,0,0,0,27,0,0,26,1,18,285,258,27
"N00002486",446,432,0,13,1,11,7,7,0,0,0,0,14,0,0,13,1,11,439,425,14
"N00002487",462,436,0,25,1,35,7,7,0,0,0,0,26,0,0,25,1,35,455,429,26
"N00002488",1345,1226,6,103,9,95,11,10,1,0,1,0,119,2,6,104,9,97,1334,1216,118
"N00002489",818,781,2,28,6,57,3,2,1,0,0,1,37,1,2,28,7,58,815,779,36
"N00002490",387,346,0,38,2,18,2,1,1,0,1,0,41,0,0,39,2,18,385,345,40
"N00002491",339,321,0,15,2,23,9,8,1,0,0,1,18,0,0,15,3,23,330,313,17
"N00002492",309,290,0,15,0,17,5,1,4,0,4,0,19,0,0,19,0,17,304,289,15
"N00002493",319,306,2,11,0,22,0,0,0,0,0,0,13,0,2,11,0,22,319,306,13
"N00002494",269,263,0,6,0,11,4,4,0,0,0,0,6,0,0,6,0,11,265,259,6
"N00002495",594,548,2,44,0,21,4,4,0,0,0,0,46,1,2,44,0,22,590,544,46
"N00002496",360,348,0,11,1,24,3,3,0,0,0,0,12,2,0,11,1,26,357,345,12
"N00002497",615,564,0,49,2,45,2,2,0,0,0,0,51,1,0,49,2,46,613,562,51
"N00002498",1256,1197,2,56,1,56,17,17,0,0,0,0,59,2,2,56,1,58,1239,1180,59
"N00002499",694,661,0,33,0,7,2,2,0,0,0,0,33,0,0,33,0,7,692,659,33
"N00002500",603,557,0,34,8,42,17,13,4,0,0,4,46,2,0,34,12,44,586,544,42
"N00002501",1778,1712,4,52,8,58,36,34,2,0,2,0,66,1,4,54,8,59,1742,1678,64
"N00002502",531,496,0,26,9,38,7,7,0,0,0,0,35,0,0,26,9,38,524,489,35
"N00002503",294,269,4,21,0,14,9,9,0,0,0,0,25,0,4,21,0,14,285,260,25
"N00002504",285,260,0,23,0,8,4,2,2,0,2,0,25,2,0,25,0,10,281,258,23
"N00002505",254,221,2,25,1,24,9,4,5,0,5,0,33,3,2,30,1,27,245,217,28
"N00002506",287,254,3,28,2,35,12,12,0,0,0,0,33,0,3,28,2,35,275,242,33
"N00002507",304,282,0,21,0,20,9,8,1,0,1,0,22,0,0,22,0,20,295,274,21
"N00002508",181,151,0,25,3,28,7,5,2,0,2,0,30,0,0,27,3,28,174,146,28
"N00002509",243,201,1,32,9,23,4,4,0,0,0,0,42,7,1,32,9,30,239,197,42
"N00002510",555,467,2,59,9,44,87,69,18,3,13,2,88,16,5,72,11,60,468,398,70
"N00002511",166,141,0,22,1,26,12,10,2,0,2,0,25,2,0,24,1,28,154,131,23
"N00002512",694,631,6,55,2,62,2,2,0,0,0,0,63,1,6,55,2,63,692,629,63
"N00002513",321,308,0,10,1,26,6,4,2,0,0,2,13,0,0,10,3,26,315,304,11
"N00002514",423,397,0,25,1,28,2,2,0,0,0,0,26,1,0,25,1,29,421,395,26
"N00002515",315,295,2,18,0,26,3,3,0,0,0,0,20,0,2,18,0,26,312,292,20
"N00002516",371,351,4,14,2,8,1,1,0,0,0,0,20,0,4,14,2,8,370,350,20
"N00002517",346,304,0,39,3,29,5,5,0,0,0,0,42,0,0,39,3,29,341,299,42
"N00002518",715,636,2,66,10,34,9,8,1,0,1,0,79,0,2,67,10,34,706,628,78
"N00002519",336,312,0,20,2,19,8,6,2,0,1,1,24,1,0,21,3,20,328,306,22
"N00002520",880,836,9,29,6,58,9,9,0,0,0,0,44,2,9,29,6,60,871,827,44
"N00002521",1352,1248,7,75,21,71,26,25,1,0,1,0,104,2,7,76,21,73,1326,1223,103
"N00002522",299,272,1,19,7,21,2,2,0,0,0,0,27,0,1,19,7,21,297,270,27
"N00002523",340,327,1,12,0,21,3,3,0,0,0,0,13,0,1,12,0,21,337,324,13
"N00002524",416,378,3,23,12,38,3,3,0,0,0,0,38,0,3,23,12,38,413,375,38
"N00002525",1801,1641,3,138,13,141,90,84,6,0,4,2,160,2,3,142,15,143,1711,1557,154
"N00002526",1103,999,4,80,11,130,70,61,9,4,5,0,104,5,8,85,11,135,1033,938,95
"N00002527",434,398,0,33,2,21,16,15,1,0,1,0,36,0,0,34,2,21,418,383,35
"N00002528",300,296,0,4,0,10,3,3,0,0,0,0,4,0,0,4,0,10,297,293,4
"N00002529",416,395,0,18,3,15,1,1,0,0,0,0,21,0,0,18,3,15,415,394,21
"N00002530",400,390,0,8,2,22,0,0,0,0,0,0,10,0,0,8,2,22,400,390,10
"N00002531",487,468,0,15,4,31,5,5,0,0,0,0,19,1,0,15,4,32,482,463,19
"N00002532",359,346,0,11,0,31,6,4,2,0,2,0,13,0,0,13,0,31,353,342,11
"N00002533",910,818,5,74,7,72,12,6,6,0,6,0,92,1,5,80,7,73,898,812,86
"N00002534",433,406,0,20,5,38,7,5,2,0,0,2,27,0,0,20,7,38,426,401,25
"N00002535",444,428,0,15,1,26,0,0,0,0,0,0,16,0,0,15,1,26,444,428,16
"N00002536",607,571,0,36,0,43,6,6,0,0,0,0,36,0,0,36,0,43,601,565,36
"N00002537",1634,1535,28,59,5,69,11,4,7,2,3,2,99,2,30,62,7,71,1623,1531,92
"N00002538",705,638,1,56,0,61,15,5,10,0,3,7,67,2,1,59,7,63,690,633,57
"N00002539",265,258,1,5,1,26,1,1,0,0,0,0,7,0,1,5,1,26,264,257,7
"N00002540",1969,1859,1,97,6,83,42,36,6,0,3,3,110,26,1,100,9,109,1927,1823,104
"N00002541",1232,1164,7,51,8,75,28,26,2,0,2,0,68,0,7,53,8,75,1204,1138,66
"N00002542",326,310,0,14,1,25,5,4,1,0,0,1,16,3,0,14,2,28,321,306,15
"N00002543",265,242,0,21,2,20,8,8,0,0,0,0,23,2,0,21,2,22,257,234,23
"N00002544",645,573,1,57,5,49,36,27,9,0,6,3,72,8,1,63,8,57,609,546,63
"N00002545",321,287,0,33,1,16,7,7,0,0,0,0,34,2,0,33,1,18,314,280,34
"N00002546",255,216,0,36,3,11,6,6,0,0,0,0,39,0,0,36,3,11,249,210,39
"N00002547",1040,985,3,49,3,67,10,10,0,0,0,0,55,0,3,49,3,67,1030,975,55
"N00002548",574,554,0,18,2,28,7,7,0,0,0,0,20,2,0,18,2,30,567,547,20
"N00002549",238,212,4,22,0,36,3,3,0,0,0,0,26,2,4,22,0,38,235,209,26
"N00002550",269,248,0,15,1,15,13,8,5,0,5,0,21,0,0,20,1,15,256,240,16
"N00002551",346,323,0,20,2,24,11,10,1,0,1,0,23,4,0,21,2,28,335,313,22
"N00002552",279,258,7,10,4,19,26,26,0,0,0,0,21,0,7,10,4,19,253,232,21
"N00002553",248,224,0,19,2,29,9,6,3,0,3,0,24,2,0,22,2,31,239,218,21
"N00002554",372,353,0,14,4,21,29,28,1,0,1,0,19,0,0,15,4,21,343,325,18
"N00002555",355,336,0,19,0,13,0,0,0,0,0,0,19,0,0,19,0,13,355,336,19
"N00002556",320,309,0,10,0,27,3,2,1,0,1,0,11,0,0,11,0,27,317,307,10
"N00002557",346,329,0,16,1,15,7,7,0,0,0,0,17,0,0,16,1,15,339,322,17
"N00002558",307,294,0,13,0,19,0,0,0,0,0,0,13,0,0,13,0,19,307,294,13
"N00002559",316,301,1,13,1,15,0,0,0,0,0,0,15,0,1,13,1,15,316,301,15
"N00002560",471,446,2,15,8,38,14,14,0,0,0,0,25,2,2,15,8,40,457,432,25
"N00002561",314,307,0,6,1,25,9,9,0,0,0,0,7,2,0,6,1,27,305,298,7
"N00002562",347,329,0,15,3,30,3,3,0,0,0,0,18,0,0,15,3,30,344,326,18
"N00002563",364,353,0,9,2,28,14,14,0,0,0,0,11,0,0,9,2,28,350,339,11
"N00002564",266,260,0,5,1,14,3,3,0,0,0,0,6,4,0,5,1,18,263,257,6
"N00002565",288,266,1,16,2,13,8,5,3,1,2,0,22,2,2,18,2,15,280,261,19
"N00002566",303,290,0,11,2,42,3,3,0,0,0,0,13,0,0,11,2,42,300,287,13
"N00002567",339,311,0,18,7,31,6,3,3,0,2,1,28,4,0,20,8,35,333,308,25
"N00002568",309,289,0,15,2,15,10,7,3,0,3,0,20,0,0,18,2,15,299,282,17
"N00002569",306,279,0,19,8,24,2,2,0,0,0,0,27,0,0,19,8,24,304,277,27
"N00002570",263,239,0,20,4,13,1,1,0,0,0,0,24,0,0,20,4,13,262,238,24
"N00002571",338,326,1,4,7,18,5,5,0,0,0,0,12,0,1,4,7,18,333,321,12
"N00002572",346,333,1,11,1,36,3,3,0,0,0,0,13,0,1,11,1,36,343,330,13
"N00002573",294,281,0,13,0,16,11,11,0,0,0,0,13,2,0,13,0,18,283,270,13
"N00002574",298,254,1,35,1,37,17,10,7,0,6,1,44,0,1,41,2,37,281,244,37
"N00002575",309,273,0,35,1,10,0,0,0,0,0,0,36,0,0,35,1,10,309,273,36
"N00002576",785,656,7,84,34,72,25,21,4,0,2,2,129,2,7,86,36,74,760,635,125
"N00002577",536,432,4,83,14,76,14,11,3,0,2,1,104,2,4,85,15,78,522,421,101
"N00002578",299,255,1,38,5,41,4,4,0,0,0,0,44,1,1,38,5,42,295,251,44
"N00002579",402,391,0,11,0,27,1,1,0,0,0,0,11,0,0,11,0,27,401,390,11
"N00002580",306,280,0,19,6,12,3,2,1,0,1,0,26,0,0,20,6,12,303,278,25
"N00002581",330,302,0,25,3,18,2,2,0,0,0,0,28,0,0,25,3,18,328,300,28
"N00002582",1465,1406,13,45,0,96,11,10,1,0,1,0,59,4,13,46,0,100,1454,1396,58
"N00002583",327,294,0,29,4,20,2,2,0,0,0,0,33,0,0,29,4,20,325,292,33
"N00002584",350,334,1,13,0,20,6,4,2,0,2,0,16,0,1,15,0,20,344,330,14
"N00002585",262,242,0,20,0,15,3,3,0,0,0,0,20,0,0,20,0,15,259,239,20
"N00002586",350,323,0,25,1,36,5,4,1,0,1,0,27,0,0,26,1,36,345,319,26
"N00002587",836,775,4,55,2,72,9,9,0,0,0,0,61,0,4,55,2,72,827,766,61
"N00002588",305,284,1,20,0,26,0,0,0,0,0,0,21,0,1,20,0,26,305,284,21
"N00002589",317,298,0,19,0,14,3,3,0,0,0,0,19,2,0,19,0,16,314,295,19
"N00002590",1559,1421,1,123,7,100,23,16,7,0,6,1,138,2,1,129,8,102,1536,1405,131
"N00002591",1265,1207,1,55,2,98,24,24,0,0,0,0,58,0,1,55,2,98,1241,1183,58
"N00002592",492,469,0,18,3,13,4,2,2,0,2,0,23,0,0,20,3,13,488,467,21
"N00002593",300,283,0,13,4,16,7,7,0,0,0,0,17,0,0,13,4,16,293,276,17
"N00002594",367,346,0,20,1,21,1,1,0,0,0,0,21,0,0,20,1,21,366,345,21
"N00002595",399,369,6,24,0,40,0,0,0,0,0,0,30,0,6,24,0,40,399,369,30
"N00002596",377,352,0,19,3,9,4,1,3,0,1,2,25,2,0,20,5,11,373,351,22
"N00002597",339,321,0,16,2,19,3,3,0,0,0,0,18,0,0,16,2,19,336,318,18
"N00002598",263,256,0,5,2,20,2,2,0,0,0,0,7,0,0,5,2,20,261,254,7
"N00002599",395,375,0,15,2,53,8,5,3,0,2,1,20,1,0,17,3,54,387,370,17
"N00002600",288,279,0,9,0,16,0,0,0,0,0,0,9,0,0,9,0,16,288,279,9
"N00002601",364,329,0,31,2,29,7,5,2,0,0,2,35,1,0,31,4,30,357,324,33
"N00002602",339,318,0,15,6,40,0,0,0,0,0,0,21,0,0,15,6,40,339,318,21
"N00002603",853,691,7,123,18,122,43,29,14,0,5,9,162,29,7,128,27,151,810,662,148
"N00002604",328,249,5,63,7,90,13,9,4,1,0,3,79,4,6,63,10,94,315,240,75
"N00002605",258,201,1,37,10,21,28,19,9,0,1,8,57,4,1,38,18,25,230,182,48
"N00002606",388,351,0,34,0,17,5,2,3,0,2,1,37,0,0,36,1,17,383,349,34
"N00002607",175,159,0,16,0,8,2,2,0,0,0,0,16,0,0,16,0,8,173,157,16
"N00002608",251,206,0,24,16,7,16,11,5,0,1,4,45,0,0,25,20,7,235,195,40
"N00002609",844,540,0,250,26,43,57,29,28,0,4,24,304,2,0,254,50,45,787,511,276
"N00002610",292,206,2,67,17,52,11,11,0,0,0,0,86,3,2,67,17,55,281,195,86
"N00002611",135,117,0,15,3,18,1,1,0,0,0,0,18,11,0,15,3,29,134,116,18
"N00002612",309,237,0,45,20,56,17,10,7,0,0,7,72,6,0,45,27,62,292,227,65
"N00002613",678,574,7,66,27,89,12,8,4,0,3,1,104,4,7,69,28,93,666,566,100
"N00002614",359,315,3,39,1,50,6,5,1,0,1,0,44,0,3,40,1,50,353,310,43
"N00002615",289,273,0,16,0,16,1,1,0,0,0,0,16,0,0,16,0,16,288,272,16
"N00002616",342,307,0,29,6,30,1,1,0,0,0,0,35,0,0,29,6,30,341,306,35
"N00002617",462,413,2,40,7,28,0,0,0,0,0,0,49,0,2,40,7,28,462,413,49
"N00002618",221,205,0,14,2,13,4,4,0,0,0,0,16,0,0,14,2,13,217,201,16
"N00002619",599,494,8,80,15,99,10,8,2,0,2,0,105,0,8,82,15,99,589,486,103
"N00002620",547,473,1,50,12,20,55,44,11,0,11,0,74,5,1,61,12,25,492,429,63
"N00002621",216,192,2,22,0,19,4,4,0,0,0,0,24,0,2,22,0,19,212,188,24
"N00002622",314,274,5,32,3,47,2,2,0,0,0,0,40,1,5,32,3,48,312,272,40
"N00002623",260,245,3,11,1,17,0,0,0,0,0,0,15,0,3,11,1,17,260,245,15
"N00002624",251,216,1,29,5,37,1,1,0,0,0,0,35,0,1,29,5,37,250,215,35
"N00002625",332,312,1,18,0,36,12,11,1,0,1,0,20,0,1,19,0,36,320,301,19
"N00002626",891,807,2,77,3,75,18,16,2,0,2,0,84,2,2,79,3,77,873,791,82
"N00002627",302,290,1,11,0,54,0,0,0,0,0,0,12,1,1,11,0,55,302,290,12
"N00002628",922,860,2,55,5,87,7,7,0,0,0,0,62,2,2,55,5,89,915,853,62
"N00002629",242,216,0,24,2,12,0,0,0,0,0,0,26,0,0,24,2,12,242,216,26
"N00002630",297,272,1,24,0,19,0,0,0,0,0,0,25,0,1,24,0,19,297,272,25
"N00002631",320,297,0,23,0,25,0,0,0,0,0,0,23,0,0,23,0,25,320,297,23
"N00002632",414,388,8,18,0,34,1,1,0,0,0,0,26,2,8,18,0,36,413,387,26
"N00002633",426,390,5,26,5,28,4,4,0,0,0,0,36,0,5,26,5,28,422,386,36
"N00002634",311,290,5,12,3,7,1,0,1,0,1,0,21,0,5,13,3,7,310,290,20
"N00002635",341,313,4,24,0,23,1,1,0,0,0,0,28,0,4,24,0,23,340,312,28
"N00002636",393,368,1,22,2,10,0,0,0,0,0,0,25,0,1,22,2,10,393,368,25
"N00002637",499,486,0,10,3,29,2,2,0,0,0,0,13,0,0,10,3,29,497,484,13
"N00002638",485,451,0,31,3,16,1,1,0,0,0,0,34,2,0,31,3,18,484,450,34
"N00002639",309,297,1,11,0,31,4,4,0,0,0,0,12,1,1,11,0,32,305,293,12
"N00002640",343,335,0,5,3,16,4,4,0,0,0,0,8,0,0,5,3,16,339,331,8
"N00002641",361,339,6,15,1,35,9,9,0,0,0,0,22,0,6,15,1,35,352,330,22
"N00002642",468,457,0,9,2,32,0,0,0,0,0,0,11,0,0,9,2,32,468,457,11
"N00002643",392,367,0,21,3,21,1,0,1,0,0,1,25,1,0,21,4,22,391,367,24
"N00002644",330,293,0,36,0,40,2,1,1,0,1,0,37,2,0,37,0,42,328,292,36
"N00002645",317,291,0,23,1,17,6,4,2,0,2,0,26,0,0,25,1,17,311,287,24
"N00002646",351,308,1,39,3,25,20,20,0,0,0,0,43,2,1,39,3,27,331,288,43
"N00002647",766,699,5,57,4,75,16,15,1,0,0,1,67,0,5,57,5,75,750,684,66
"N00002648",202,177,2,21,2,27,2,2,0,0,0,0,25,0,2,21,2,27,200,175,25
"N00002649",496,467,0,28,1,15,4,4,0,0,0,0,29,0,0,28,1,15,492,463,29
"N00002650",305,283,8,13,1,26,0,0,0,0,0,0,22,0,8,13,1,26,305,283,22
"N00002651",479,454,0,25,0,49,7,7,0,0,0,0,25,1,0,25,0,50,472,447,25
"N00002652",297,273,10,13,1,14,0,0,0,0,0,0,24,0,10,13,1,14,297,273,24
"N00002653",444,398,3,41,0,29,21,19,2,0,1,1,46,0,3,42,1,29,423,379,44
"N00002654",337,280,4,52,1,31,4,4,0,0,0,0,57,0,4,52,1,31,333,276,57
"N00002655",280,229,7,41,0,41,7,4,3,0,2,1,51,0,7,43,1,41,273,225,48
"N00002656",717,631,4,73,2,58,22,15,7,0,7,0,86,4,4,80,2,62,695,616,79
"N00002657",370,336,0,28,6,58,6,6,0,0,0,0,34,0,0,28,6,58,364,330,34
"N00002658",429,392,6,29,0,36,3,1,2,0,2,0,37,1,6,31,0,37,426,391,35
"N00002659",357,313,0,44,0,28,5,5,0,0,0,0,44,2,0,44,0,30,352,308,44
"N00002660",427,374,0,51,1,34,9,8,1,0,1,0,53,0,0,52,1,34,418,366,52
"N00002661",490,456,1,33,0,32,9,9,0,0,0,0,34,0,1,33,0,32,481,447,34
"N00002662",402,360,0,36,2,17,6,2,4,0,4,0,42,0,0,40,2,17,396,358,38
"N00002663",340,321,2,15,2,32,4,4,0,0,0,0,19,4,2,15,2,36,336,317,19
"N00002664",298,258,3,32,2,13,7,4,3,0,3,0,40,0,3,35,2,13,291,254,37
"N00002665",277,267,3,5,2,30,0,0,0,0,0,0,10,2,3,5,2,32,277,267,10
"N00002666",263,241,0,21,1,19,3,3,0,0,0,0,22,0,0,21,1,19,260,238,22
"N00002667",778,713,9,52,2,80,9,7,2,0,1,1,65,0,9,53,3,80,769,706,63
"N00002668",317,295,0,18,3,28,3,2,1,0,1,0,22,3,0,19,3,31,314,293,21
"N00002669",530,489,7,30,3,22,8,7,1,0,1,0,41,1,7,31,3,23,522,482,40
"N00002670",1917,1746,23,135,11,93,24,22,2,0,2,0,171,1,23,137,11,94,1893,1724,169
"N00002671",1354,1276,10,64,0,83,19,15,4,0,4,0,78,4,10,68,0,87,1335,1261,74
"N00002672",333,305,1,25,2,38,2,2,0,0,0,0,28,2,1,25,2,40,331,303,28
"N00002673",1282,1164,6,102,3,121,34,27,7,0,3,4,118,4,6,105,7,125,1248,1137,111
"N00002674",289,272,1,16,0,28,5,5,0,0,0,0,17,0,1,16,0,28,284,267,17
"N00002675",385,378,1,6,0,28,4,4,0,0,0,0,7,0,1,6,0,28,381,374,7
"N00002676",708,660,3,42,2,34,3,2,1,0,1,0,48,0,3,43,2,34,705,658,47
"N00002677",408,380,0,26,2,28,1,1,0,0,0,0,28,0,0,26,2,28,407,379,28
"N00002678",368,326,3,30,9,40,0,0,0,0,0,0,42,0,3,30,9,40,368,326,42
"N00002679",534,494,6,32,2,38,5,5,0,0,0,0,40,0,6,32,2,38,529,489,40
"N00002680",430,422,0,7,1,23,3,3,0,0,0,0,8,0,0,7,1,23,427,419,8
"N00002681",436,425,0,9,2,25,1,1,0,0,0,0,11,2,0,9,2,27,435,424,11
"N00002682",457,415,4,36,1,21,4,3,1,0,1,0,42,0,4,37,1,21,453,412,41
"N00002683",395,369,0,26,0,14,2,2,0,0,0,0,26,0,0,26,0,14,393,367,26
"N00002684",458,418,4,31,1,15,6,2,4,0,4,0,40,0,4,35,1,15,452,416,36
"N00002685",385,356,0,27,2,12,0,0,0,0,0,0,29,1,0,27,2,13,385,356,29
"N00002686",337,309,0,25,3,32,1,1,0,0,0,0,28,0,0,25,3,32,336,308,28
"N00002687",306,298,0,8,0,17,3,3,0,0,0,0,8,0,0,8,0,17,303,295,8
"N00002688",375,350,0,20,5,19,0,0,0,0,0,0,25,0,0,20,5,19,375,350,25
"N00002689",308,279,5,22,0,27,2,0,2,0,0,2,29,0,5,22,2,27,306,279,27
"N00002690",249,209,1,38,1,39,3,3,0,0,0,0,40,0,1,38,1,39,246,206,40
"N00002691",325,297,0,24,1,16,6,3,3,0,3,0,28,1,0,27,1,17,319,294,25
"N00002692",276,251,1,24,0,23,1,1,0,0,0,0,25,0,1,24,0,23,275,250,25
"N00002693",338,288,4,43,2,37,7,6,1,0,1,0,50,0,4,44,2,37,331,282,49
"N00002694",319,303,0,10,6,21,2,2,0,0,0,0,16,1,0,10,6,22,317,301,16
"N00002695",467,455,0,11,1,36,5,5,0,0,0,0,12,0,0,11,1,36,462,450,12
"N00002696",316,302,0,13,1,21,4,4,0,0,0,0,14,0,0,13,1,21,312,298,14
"N00002697",367,337,2,24,4,28,2,2,0,0,0,0,30,0,2,24,4,28,365,335,30
"N00002698",536,471,3,53,9,15,13,13,0,0,0,0,65,2,3,53,9,17,523,458,65
"N00002699",351,313,3,34,1,33,0,0,0,0,0,0,38,0,3,34,1,33,351,313,38
"N00002700",529,465,2,60,2,33,3,3,0,0,0,0,64,2,2,60,2,35,526,462,64
"N00002701",533,507,0,20,6,26,1,1,0,0,0,0,26,0,0,20,6,26,532,506,26
"N00002702",371,350,1,20,0,25,0,0,0,0,0,0,21,0,1,20,0,25,371,350,21
"N00002703",614,580,3,29,2,34,1,1,0,0,0,0,34,0,3,29,2,34,613,579,34
"N00002704",558,528,2,24,4,21,0,0,0,0,0,0,30,0,2,24,4,21,558,528,30
"N00002705",483,459,6,17,1,26,0,0,0,0,0,0,24,0,6,17,1,26,483,459,24
"N00002706",437,418,0,19,0,12,5,5,0,0,0,0,19,0,0,19,0,12,432,413,19
"N00002707",564,513,5,45,1,40,2,2,0,0,0,0,51,1,5,45,1,41,562,511,51
"N00002708",264,242,1,19,2,24,0,0,0,0,0,0,22,0,1,19,2,24,264,242,22
"N00002709",468,408,1,58,1,29,3,3,0,0,0,0,60,0,1,58,1,29,465,405,60
"N00002710",418,375,0,40,0,33,4,1,3,0,3,0,43,0,0,43,0,33,414,374,40
"N00002711",764,689,3,57,15,53,10,10,0,0,0,0,75,3,3,57,15,56,754,679,75
"N00002712",373,359,2,12,0,33,1,1,0,0,0,0,14,0,2,12,0,33,372,358,14
"N00002713",424,401,2,18,0,25,3,0,3,0,3,0,23,0,2,21,0,25,421,401,20
"N00002714",490,470,1,18,1,35,1,1,0,0,0,0,20,0,1,18,1,35,489,469,20
"N00002715",424,411,0,13,0,23,5,5,0,0,0,0,13,0,0,13,0,23,419,406,13
"N00002716",348,326,0,21,1,16,4,4,0,0,0,0,22,0,0,21,1,16,344,322,22
"N00002717",566,533,4,28,1,40,0,0,0,0,0,0,33,1,4,28,1,41,566,533,33
"N00002718",473,458,0,15,0,20,9,9,0,0,0,0,15,1,0,15,0,21,464,449,15
"N00002719",333,315,0,13,5,31,2,2,0,0,0,0,18,0,0,13,5,31,331,313,18
"N00002720",344,314,1,26,3,30,1,1,0,0,0,0,30,0,1,26,3,30,343,313,30
"N00002721",363,335,1,23,3,15,1,0,1,0,1,0,28,0,1,24,3,15,362,335,27
"N00002722",437,419,3,14,1,39,1,1,0,0,0,0,18,0,3,14,1,39,436,418,18
"N00002723",407,397,1,9,0,19,1,1,0,0,0,0,10,2,1,9,0,21,406,396,10
"N00002724",230,214,2,14,0,20,2,2,0,0,0,0,16,0,2,14,0,20,228,212,16
"N00002725",433,416,1,16,0,15,12,12,0,0,0,0,17,0,1,16,0,15,421,404,17
"N00002726",1345,1135,18,149,19,106,73,49,24,5,12,7,210,8,23,161,26,114,1272,1086,186
"N00002727",390,354,3,23,9,17,1,0,1,0,0,1,36,0,3,23,10,17,389,354,35
"N00002728",1055,940,13,100,1,70,15,14,1,0,1,0,115,0,13,101,1,70,1040,926,114
"N00002729",293,274,0,19,0,27,3,3,0,0,0,0,19,0,0,19,0,27,290,271,19
"N00002730",271,256,2,12,1,29,1,1,0,0,0,0,15,4,2,12,1,33,270,255,15
"N00002731",277,256,2,19,0,51,1,1,0,0,0,0,21,1,2,19,0,52,276,255,21
"N00002732",307,286,0,18,1,57,2,0,2,0,1,1,21,0,0,19,2,57,305,286,19
"N00002733",401,348,0,46,4,38,11,8,3,0,1,2,53,1,0,47,6,39,390,340,50
"N00002734",493,456,0,33,4,43,6,6,0,0,0,0,37,0,0,33,4,43,487,450,37
"N00002735",431,408,0,23,0,27,0,0,0,0,0,0,23,0,0,23,0,27,431,408,23
"N00002736",357,342,0,14,1,19,3,3,0,0,0,0,15,0,0,14,1,19,354,339,15
"N00002737",320,310,0,8,2,15,4,4,0,0,0,0,10,0,0,8,2,15,316,306,10
"N00002738",456,430,0,22,1,16,3,0,3,0,0,3,26,0,0,22,4,16,453,430,23
"N00002739",398,372,0,26,0,14,1,1,0,0,0,0,26,0,0,26,0,14,397,371,26
"N00002740",383,356,0,25,2,35,0,0,0,0,0,0,27,1,0,25,2,36,383,356,27
"N00002741",456,421,5,28,2,19,3,3,0,0,0,0,35,0,5,28,2,19,453,418,35
"N00002742",379,342,0,36,1,23,4,4,0,0,0,0,37,0,0,36,1,23,375,338,37
"N00002743",364,327,0,35,1,59,3,2,1,0,1,0,37,1,0,36,1,60,361,325,36
"N00002744",267,238,8,18,3,30,4,4,0,0,0,0,29,0,8,18,3,30,263,234,29
"N00002745",324,307,0,12,0,12,6,1,5,0,5,0,17,0,0,17,0,12,318,306,12
"N00002746",309,292,0,14,3,35,1,1,0,0,0,0,17,0,0,14,3,35,308,291,17
"N00002747",262,232,0,25,5,19,0,0,0,0,0,0,30,0,0,25,5,19,262,232,30
"N00002748",351,318,0,31,2,15,1,1,0,0,0,0,33,1,0,31,2,16,350,317,33
"N00002749",334,278,5,44,6,35,7,6,1,0,1,0,56,0,5,45,6,35,327,272,55
"N00002750",261,232,0,28,1,33,8,8,0,0,0,0,29,1,0,28,1,34,253,224,29
"N00002751",301,255,5,38,3,48,1,1,0,0,0,0,46,8,5,38,3,56,300,254,46
"N00002752",283,268,0,11,0,32,6,2,4,0,4,0,15,0,0,15,0,32,277,266,11
"N00002753",524,498,1,21,3,37,13,12,1,0,1,0,26,4,1,22,3,41,511,486,25
"N00002754",410,393,0,15,1,19,11,10,1,0,0,1,17,0,0,15,2,19,399,383,16
"N00002755",589,544,4,37,3,32,9,8,1,0,0,1,45,0,4,37,4,32,580,536,44
"N00002756",315,302,0,12,1,10,6,6,0,0,0,0,13,0,0,12,1,10,309,296,13
"N00002757",483,445,1,36,0,47,5,4,1,0,1,0,38,0,1,37,0,47,478,441,37
"N00002758",254,235,1,18,0,24,2,2,0,0,0,0,19,0,1,18,0,24,252,233,19
"N00002759",337,323,0,12,2,15,19,19,0,0,0,0,14,0,0,12,2,15,318,304,14
"N00002760",306,279,0,27,0,16,0,0,0,0,0,0,27,0,0,27,0,16,306,279,27
"N00002761",941,847,0,93,0,62,9,8,1,0,1,0,94,1,0,94,0,63,932,839,93
"N00002762",364,358,0,5,1,31,4,4,0,0,0,0,6,0,0,5,1,31,360,354,6
"N00002763",381,363,0,18,0,25,8,8,0,0,0,0,18,0,0,18,0,25,373,355,18
"N00002764",427,390,1,33,3,36,0,0,0,0,0,0,37,0,1,33,3,36,427,390,37
"N00002765",371,353,0,17,1,22,0,0,0,0,0,0,18,2,0,17,1,24,371,353,18
"N00002766",499,482,2,14,1,30,0,0,0,0,0,0,17,0,2,14,1,30,499,482,17
"N00002767",396,379,0,16,1,16,2,2,0,0,0,0,17,0,0,16,1,16,394,377,17
"N00002768",362,325,0,36,1,26,0,0,0,0,0,0,37,1,0,36,1,27,362,325,37
"N00002769",483,464,2,15,2,30,2,2,0,0,0,0,19,0,2,15,2,30,481,462,19
"N00002770",463,438,8,16,1,28,0,0,0,0,0,0,25,0,8,16,1,28,463,438,25
"N00002771",272,256,0,15,0,22,5,4,1,0,1,0,16,0,0,16,0,22,267,252,15
"N00002772",297,274,0,15,8,14,2,2,0,0,0,0,23,4,0,15,8,18,295,272,23
"N00002773",217,202,0,13,0,11,3,1,2,0,0,2,15,0,0,13,2,11,214,201,13
"N00002774",640,603,2,34,1,51,21,21,0,0,0,0,37,0,2,34,1,51,619,582,37
"N00002775",478,438,0,34,1,55,13,8,5,0,5,0,40,4,0,39,1,59,465,430,35
"N00002776",292,275,0,15,2,43,2,2,0,0,0,0,17,0,0,15,2,43,290,273,17
"N00002777",237,215,0,21,0,20,2,1,1,0,1,0,22,0,0,22,0,20,235,214,21
"N00002778",254,208,1,33,7,44,10,5,5,0,5,0,46,0,1,38,7,44,244,203,41
"N00002779",496,473,1,18,4,37,0,0,0,0,0,0,23,0,1,18,4,37,496,473,23
"N00002780",345,313,0,31,0,17,5,4,1,0,1,0,32,0,0,32,0,17,340,309,31
"N00002781",401,378,1,21,1,19,2,2,0,0,0,0,23,0,1,21,1,19,399,376,23
"N00002782",510,474,1,32,3,30,0,0,0,0,0,0,36,0,1,32,3,30,510,474,36
"N00002783",390,359,1,30,0,16,2,2,0,0,0,0,31,0,1,30,0,16,388,357,31
"N00002784",544,516,3,22,3,45,1,1,0,0,0,0,28,2,3,22,3,47,543,515,28
"N00002785",599,540,11,44,4,29,1,1,0,0,0,0,59,0,11,44,4,29,598,539,59
"N00002786",503,474,0,28,1,15,13,13,0,0,0,0,29,0,0,28,1,15,490,461,29
"N00002787",464,442,0,22,0,18,6,6,0,0,0,0,22,0,0,22,0,18,458,436,22
"N00002788",370,349,2,15,4,12,1,1,0,0,0,0,21,1,2,15,4,13,369,348,21
"N00002789",539,494,3,38,3,42,2,1,1,0,1,0,45,0,3,39,3,42,537,493,44
"N00002790",493,466,3,19,5,35,0,0,0,0,0,0,27,0,3,19,5,35,493,466,27
"N00002791",419,388,1,27,2,15,8,7,1,0,0,1,31,0,1,27,3,15,411,381,30
"N00002792",479,455,1,21,1,17,4,3,1,0,1,0,24,0,1,22,1,17,475,452,23
"N00002793",452,421,1,29,0,12,1,0,1,0,1,0,31,0,1,30,0,12,451,421,30
"N00002794",551,515,3,32,1,18,11,11,0,0,0,0,36,2,3,32,1,20,540,504,36
"N00002795",539,523,0,15,1,14,5,5,0,0,0,0,16,0,0,15,1,14,534,518,16
"N00002796",571,545,1,24,1,17,2,2,0,0,0,0,26,0,1,24,1,17,569,543,26
"N00002797",551,517,0,25,9,11,1,1,0,0,0,0,34,1,0,25,9,12,550,516,34
"N00002798",415,396,3,12,4,27,6,6,0,0,0,0,19,1,3,12,4,28,409,390,19
"N00002799",308,289,4,15,0,25,0,0,0,0,0,0,19,0,4,15,0,25,308,289,19
"N00002800",406,376,0,23,6,13,3,2,1,0,1,0,30,2,0,24,6,15,403,374,29
"N00002801",486,463,1,17,5,29,0,0,0,0,0,0,23,0,1,17,5,29,486,463,23
"N00002802",452,437,2,8,5,13,7,7,0,0,0,0,15,0,2,8,5,13,445,430,15
"N00002803",506,448,4,41,10,29,8,5,3,0,3,0,58,0,4,44,10,29,498,443,55
"N00002804",412,358,6,36,9,6,3,0,3,0,3,0,54,0,6,39,9,6,409,358,51
"N00002805",384,347,4,18,15,40,0,0,0,0,0,0,37,3,4,18,15,43,384,347,37
"N00002806",495,475,4,13,1,23,6,4,2,0,2,0,20,1,4,15,1,24,489,471,18
"N00002807",402,364,0,29,9,17,4,4,0,0,0,0,38,0,0,29,9,17,398,360,38
"N00002808",513,482,2,29,0,27,0,0,0,0,0,0,31,0,2,29,0,27,513,482,31
"N00002809",491,465,1,25,0,27,0,0,0,0,0,0,26,0,1,25,0,27,491,465,26
"N00002810",325,303,0,16,6,16,0,0,0,0,0,0,22,3,0,16,6,19,325,303,22
"N00002811",340,320,0,17,3,25,1,1,0,0,0,0,20,2,0,17,3,27,339,319,20
"N00002812",397,375,2,19,1,15,1,1,0,0,0,0,22,0,2,19,1,15,396,374,22
"N00002813",449,418,3,21,2,17,6,1,5,0,4,1,31,0,3,25,3,17,443,417,26
"N00002814",501,393,5,73,12,47,49,31,18,5,4,9,108,5,10,77,21,52,452,362,90
"N00002815",327,290,2,25,3,8,51,44,7,0,4,3,37,9,2,29,6,17,276,246,30
"N00002816",358,298,1,26,16,12,22,5,17,0,2,15,60,3,1,28,31,15,336,293,43
"N00002817",631,549,2,47,31,36,38,36,2,0,1,1,82,7,2,48,32,43,593,513,80
"N00002818",465,393,1,39,30,44,27,25,2,0,1,1,72,2,1,40,31,46,438,368,70
"N00002819",448,401,1,26,9,43,37,26,11,0,2,9,47,1,1,28,18,44,411,375,36
"N00002820",609,567,1,21,20,29,7,7,0,0,0,0,42,1,1,21,20,30,602,560,42
"N00002821",457,444,4,9,0,9,2,2,0,0,0,0,13,0,4,9,0,9,455,442,13
"N00002822",393,354,4,24,11,17,1,1,0,0,0,0,39,0,4,24,11,17,392,353,39
"N00002823",375,352,1,19,3,16,0,0,0,0,0,0,23,0,1,19,3,16,375,352,23
"N00002824",372,346,0,19,7,22,2,2,0,0,0,0,26,1,0,19,7,23,370,344,26
"N00002825",654,609,3,29,9,17,7,3,4,0,4,0,45,0,3,33,9,17,647,606,41
"N00002826",406,373,7,26,0,43,1,1,0,0,0,0,33,1,7,26,0,44,405,372,33
"N00002827",360,344,0,15,1,21,2,2,0,0,0,0,16,0,0,15,1,21,358,342,16
"N00002828",344,302,7,30,3,30,7,5,2,0,0,2,42,1,7,30,5,31,337,297,40
"N00002829",477,450,1,22,4,23,3,3,0,0,0,0,27,0,1,22,4,23,474,447,27
"N00002830",451,425,0,26,0,24,0,0,0,0,0,0,26,0,0,26,0,24,451,425,26
"N00002831",472,445,2,25,0,25,1,1,0,0,0,0,27,0,2,25,0,25,471,444,27
"N00002832",403,374,0,23,3,36,5,2,3,0,1,2,29,1,0,24,5,37,398,372,26
"N00002833",390,380,4,6,0,26,0,0,0,0,0,0,10,0,4,6,0,26,390,380,10
"N00002834",632,599,2,26,3,17,5,3,2,0,2,0,33,0,2,28,3,17,627,596,31
"N00002835",511,485,0,22,4,31,2,2,0,0,0,0,26,3,0,22,4,34,509,483,26
"N00002836",444,416,3,18,5,25,5,3,2,0,1,1,28,0,3,19,6,25,439,413,26
"N00002837",333,302,7,21,3,7,0,0,0,0,0,0,31,0,7,21,3,7,333,302,31
"N00002838",454,443,0,7,4,23,0,0,0,0,0,0,11,0,0,7,4,23,454,443,11
"N00002839",367,345,0,14,8,13,0,0,0,0,0,0,22,0,0,14,8,13,367,345,22
"N00002840",1431,1321,15,55,32,29,17,9,8,0,3,5,110,3,15,58,37,32,1414,1312,102
"N00002841",519,492,2,18,2,25,45,40,5,0,5,0,27,0,2,23,2,25,474,452,22
"N00002842",622,580,2,35,5,33,18,18,0,0,0,0,42,7,2,35,5,40,604,562,42
"N00002843",389,359,0,25,4,18,4,3,1,0,0,1,30,0,0,25,5,18,385,356,29
"N00002844",413,365,1,39,4,11,23,19,4,0,4,0,48,0,1,43,4,11,390,346,44
"N00002845",314,279,0,26,3,4,9,3,6,0,6,0,35,0,0,32,3,4,305,276,29
"N00002846",629,572,5,48,4,54,7,7,0,0,0,0,57,0,5,48,4,54,622,565,57
"N00002847",644,619,0,20,5,42,5,5,0,0,0,0,25,0,0,20,5,42,639,614,25
"N00002848",1266,1160,8,81,14,102,23,20,3,0,3,0,106,1,8,84,14,103,1243,1140,103
"N00002849",217,197,0,14,6,5,5,5,0,0,0,0,20,0,0,14,6,5,212,192,20
"N00002850",294,261,0,26,4,16,4,1,3,0,3,0,33,3,0,29,4,19,290,260,30
"N00002851",401,371,2,20,6,15,13,11,2,0,2,0,30,0,2,22,6,15,388,360,28
"N00002852",307,273,0,17,16,35,3,2,1,1,0,0,34,0,1,17,16,35,304,271,33
"N00002853",1040,951,6,63,16,100,32,28,4,0,3,1,89,2,6,66,17,102,1008,923,85
"N00002854",474,431,0,39,4,11,22,22,0,0,0,0,43,0,0,39,4,11,452,409,43
"N00002855",454,417,6,31,0,66,3,3,0,0,0,0,37,0,6,31,0,66,451,414,37
"N00002856",314,292,0,13,8,13,1,0,1,0,0,1,22,0,0,13,9,13,313,292,21
"N00002857",521,489,1,31,0,20,10,10,0,0,0,0,32,0,1,31,0,20,511,479,32
"N00002858",440,357,1,39,26,51,69,52,17,0,6,11,83,16,1,45,37,67,371,305,66
"N00002859",540,467,4,41,23,74,23,18,5,0,5,0,73,2,4,46,23,76,517,449,68
"N00002860",368,325,0,27,13,31,11,8,3,0,0,3,43,1,0,27,16,32,357,317,40
"N00002861",421,353,3,21,25,56,59,40,19,1,4,14,68,2,4,25,39,58,362,313,49
"N00002862",271,236,0,23,12,34,4,4,0,0,0,0,35,1,0,23,12,35,267,232,35
"N00002863",329,302,0,23,2,17,21,19,2,0,2,0,27,4,0,25,2,21,308,283,25
"N00002864",347,321,0,25,1,31,4,4,0,0,0,0,26,1,0,25,1,32,343,317,26
"N00002865",643,617,1,22,3,15,7,7,0,0,0,0,26,0,1,22,3,15,636,610,26
"N00002866",482,459,0,21,2,15,0,0,0,0,0,0,23,0,0,21,2,15,482,459,23
"N00002867",573,531,1,34,7,29,2,2,0,0,0,0,42,0,1,34,7,29,571,529,42
"N00002868",488,456,4,23,5,48,3,3,0,0,0,0,32,0,4,23,5,48,485,453,32
"N00002869",402,370,0,28,4,19,7,7,0,0,0,0,32,0,0,28,4,19,395,363,32
"N00002870",587,521,0,38,19,51,30,21,9,0,3,6,66,0,0,41,25,51,557,500,57
"N00002871",864,745,7,63,39,96,71,61,10,0,6,4,119,19,7,69,43,115,793,684,109
"N00002872",313,282,0,22,5,15,18,14,4,0,2,2,31,2,0,24,7,17,295,268,27
"N00002873",298,255,0,25,8,13,25,15,10,0,1,9,43,2,0,26,17,15,273,240,33
"N00002874",295,258,0,22,2,21,32,19,13,0,12,1,37,7,0,34,3,28,263,239,24
"N00002875",1081,1024,10,43,4,60,2,2,0,0,0,0,57,1,10,43,4,61,1079,1022,57
"N00002876",531,472,4,51,4,72,11,11,0,0,0,0,59,2,4,51,4,74,520,461,59
"N00002877",297,277,1,13,6,27,0,0,0,0,0,0,20,0,1,13,6,27,297,277,20
"N00002878",205,173,0,30,2,23,0,0,0,0,0,0,32,0,0,30,2,23,205,173,32
"N00002879",434,406,1,27,0,21,0,0,0,0,0,0,28,0,1,27,0,21,434,406,28
"N00002880",438,419,0,17,2,16,6,6,0,0,0,0,19,0,0,17,2,16,432,413,19
"N00002881",523,468,1,51,3,63,0,0,0,0,0,0,55,0,1,51,3,63,523,468,55
"N00002882",375,359,5,11,0,17,5,5,0,0,0,0,16,0,5,11,0,17,370,354,16
"N00002883",478,448,0,26,0,20,8,4,4,0,4,0,30,0,0,30,0,20,470,444,26
"N00002884",476,458,0,18,0,22,0,0,0,0,0,0,18,0,0,18,0,22,476,458,18
"N00002885",659,547,0,61,31,51,55,35,20,1,10,9,112,11,1,71,40,62,604,512,92
"N00002886",823,682,9,68,54,51,44,34,10,0,3,7,141,13,9,71,61,64,779,648,131
"N00002887",661,561,4,68,24,57,11,7,4,0,4,0,100,9,4,72,24,66,650,554,96
"N00002888",424,399,5,9,7,26,11,7,4,0,4,0,25,0,5,13,7,26,413,392,21
"N00002889",324,291,2,16,10,42,17,12,5,1,4,0,33,4,3,20,10,46,307,279,28
"N00002890",406,391,0,14,1,16,0,0,0,0,0,0,15,1,0,14,1,17,406,391,15
"N00002891",633,597,1,27,7,39,8,7,1,0,1,0,36,0,1,28,7,39,625,590,35
"N00002892",500,469,5,15,11,27,10,10,0,0,0,0,31,0,5,15,11,27,490,459,31
"N00002893",274,238,4,23,9,31,1,1,0,0,0,0,36,3,4,23,9,34,273,237,36
"N00002894",341,318,0,14,9,20,4,4,0,0,0,0,23,0,0,14,9,20,337,314,23
"N00002895",502,467,1,30,1,40,3,0,3,0,2,1,35,0,1,32,2,40,499,467,32
"N00002896",353,342,1,10,0,18,2,2,0,0,0,0,11,0,1,10,0,18,351,340,11
"N00002897",998,917,2,50,12,84,40,23,17,0,13,4,81,0,2,63,16,84,958,894,64
"N00002898",302,274,0,17,4,34,26,19,7,0,5,2,28,4,0,22,6,38,276,255,21
"N00002899",303,288,0,15,0,18,3,3,0,0,0,0,15,0,0,15,0,18,300,285,15
"N00002900",309,292,0,17,0,23,7,7,0,0,0,0,17,0,0,17,0,23,302,285,17
"N00002901",277,265,0,9,3,2,1,1,0,0,0,0,12,0,0,9,3,2,276,264,12
"N00002902",329,282,0,32,6,14,14,5,9,0,7,2,47,1,0,39,8,15,315,277,38
"N00002903",747,632,9,52,23,67,101,70,31,4,17,10,115,25,13,69,33,92,646,562,84
"N00002904",422,382,0,31,0,28,17,8,9,0,2,7,40,2,0,33,7,30,405,374,31
"N00002905",433,398,0,25,10,28,14,14,0,0,0,0,35,0,0,25,10,28,419,384,35
"N00002906",420,399,1,8,2,23,37,27,10,0,6,4,21,0,1,14,6,23,383,372,11
"N00002907",634,621,0,11,2,24,2,2,0,0,0,0,13,2,0,11,2,26,632,619,13
"N00002908",474,440,2,29,3,20,0,0,0,0,0,0,34,0,2,29,3,20,474,440,34
"N00002909",558,538,1,17,2,21,0,0,0,0,0,0,20,0,1,17,2,21,558,538,20
"N00002910",716,679,0,29,8,15,8,8,0,0,0,0,37,0,0,29,8,15,708,671,37
"N00002911",724,692,2,25,4,19,6,5,1,0,1,0,32,0,2,26,4,19,718,687,31
"N00002912",345,323,2,19,0,11,3,2,1,0,1,0,22,0,2,20,0,11,342,321,21
"N00002913",309,291,2,13,3,14,1,1,0,0,0,0,18,0,2,13,3,14,308,290,18
"N00002914",1272,1189,13,61,7,57,11,9,2,0,0,2,83,0,13,61,9,57,1261,1180,81
"N00002915",217,207,0,9,1,4,0,0,0,0,0,0,10,0,0,9,1,4,217,207,10
"N00002916",443,420,1,17,5,41,4,4,0,0,0,0,23,0,1,17,5,41,439,416,23
"N00002917",308,276,6,20,6,16,0,0,0,0,0,0,32,0,6,20,6,16,308,276,32
"N00002918",339,326,0,12,1,15,0,0,0,0,0,0,13,0,0,12,1,15,339,326,13
"N00002919",391,384,0,4,2,15,1,0,1,0,0,1,7,0,0,4,3,15,390,384,6
"N00002920",375,357,4,9,5,15,0,0,0,0,0,0,18,0,4,9,5,15,375,357,18
"N00002921",309,300,0,5,4,15,3,3,0,0,0,0,9,0,0,5,4,15,306,297,9
"N00002922",468,406,9,40,13,33,1,1,0,0,0,0,62,0,9,40,13,33,467,405,62
"N00002923",351,325,6,19,1,31,4,4,0,0,0,0,26,0,6,19,1,31,347,321,26
"N00002924",386,352,3,19,10,19,4,2,2,0,1,1,34,0,3,20,11,19,382,350,32
"N00002925",311,271,4,24,11,33,4,3,1,0,0,1,40,0,4,24,12,33,307,268,39
"N00002926",368,334,2,25,7,29,3,3,0,0,0,0,34,0,2,25,7,29,365,331,34
"N00002927",390,362,0,26,2,18,0,0,0,0,0,0,28,0,0,26,2,18,390,362,28
"N00002928",358,324,3,26,5,28,0,0,0,0,0,0,34,0,3,26,5,28,358,324,34
"N00002929",727,682,5,32,4,19,18,14,4,0,4,0,45,0,5,36,4,19,709,668,41
"N00002930",416,393,0,20,3,19,2,2,0,0,0,0,23,1,0,20,3,20,414,391,23
"N00002931",628,573,4,45,6,40,7,7,0,0,0,0,55,1,4,45,6,41,621,566,55
"N00002932",393,365,0,25,1,18,4,2,2,0,1,1,28,1,0,26,2,19,389,363,26
"N00002933",522,504,4,13,1,26,8,8,0,0,0,0,18,1,4,13,1,27,514,496,18
"N00002934",429,398,0,29,2,26,0,0,0,0,0,0,31,0,0,29,2,26,429,398,31
"N00002935",402,385,1,11,5,9,1,1,0,0,0,0,17,0,1,11,5,9,401,384,17
"N00002936",395,360,3,30,2,17,2,2,0,0,0,0,35,0,3,30,2,17,393,358,35
"N00002937",409,388,3,17,1,15,4,4,0,0,0,0,21,1,3,17,1,16,405,384,21
"N00002938",420,412,1,7,0,45,0,0,0,0,0,0,8,0,1,7,0,45,420,412,8
"N00002939",411,401,0,9,1,29,7,7,0,0,0,0,10,0,0,9,1,29,404,394,10
"N00002940",388,375,1,9,3,7,0,0,0,0,0,0,13,0,1,9,3,7,388,375,13
"N00002941",312,291,0,15,6,16,0,0,0,0,0,0,21,0,0,15,6,16,312,291,21
"N00002942",427,375,4,42,6,19,1,1,0,0,0,0,52,0,4,42,6,19,426,374,52
"N00002943",288,250,0,31,6,50,1,0,1,0,0,1,38,4,0,31,7,54,287,250,37
"N00002944",633,558,0,54,21,44,10,10,0,0,0,0,75,8,0,54,21,52,623,548,75
"N00002945",378,352,0,25,1,23,4,4,0,0,0,0,26,2,0,25,1,25,374,348,26
"N00002946",297,276,0,16,5,19,0,0,0,0,0,0,21,0,0,16,5,19,297,276,21
"N00002947",396,357,0,34,3,29,4,2,2,0,2,0,39,0,0,36,3,29,392,355,37
"N00002948",345,325,0,15,5,37,11,11,0,0,0,0,20,0,0,15,5,37,334,314,20
"N00002949",360,340,0,18,2,20,6,6,0,0,0,0,20,0,0,18,2,20,354,334,20
"N00002950",396,347,0,30,17,47,6,4,2,0,2,0,49,0,0,32,17,47,390,343,47
"N00002951",231,205,0,18,8,30,1,1,0,0,0,0,26,2,0,18,8,32,230,204,26
"N00002952",326,290,1,29,5,32,6,5,1,0,1,0,36,0,1,30,5,32,320,285,35
"N00002953",226,193,0,24,8,31,1,0,1,0,1,0,33,0,0,25,8,31,225,193,32
"N00002954",639,600,0,28,11,45,6,6,0,0,0,0,39,0,0,28,11,45,633,594,39
"N00002955",438,406,5,19,7,26,6,5,1,0,1,0,32,0,5,20,7,26,432,401,31
"N00002956",358,325,6,24,3,33,4,4,0,0,0,0,33,2,6,24,3,35,354,321,33
"N00002957",378,353,0,24,0,16,1,0,1,0,1,0,25,0,0,25,0,16,377,353,24
"N00002958",453,434,0,18,1,15,3,3,0,0,0,0,19,0,0,18,1,15,450,431,19
"N00002959",546,511,7,26,2,34,5,5,0,0,0,0,35,1,7,26,2,35,541,506,35
"N00002960",350,320,1,22,7,20,2,2,0,0,0,0,30,0,1,22,7,20,348,318,30
"N00002961",326,311,2,10,2,15,1,0,1,0,1,0,15,0,2,11,2,15,325,311,14
"N00002962",374,324,11,19,20,22,3,3,0,0,0,0,50,0,11,19,20,22,371,321,50
"N00002963",368,332,1,25,9,11,3,2,1,0,1,0,36,0,1,26,9,11,365,330,35
"N00002964",373,359,0,7,7,9,8,8,0,0,0,0,14,0,0,7,7,9,365,351,14
"N00002965",311,278,8,17,8,15,1,1,0,0,0,0,33,0,8,17,8,15,310,277,33
"N00002966",576,543,1,20,12,22,2,2,0,0,0,0,33,1,1,20,12,23,574,541,33
"N00002967",277,256,0,20,1,16,12,12,0,0,0,0,21,0,0,20,1,16,265,244,21
"N00002968",279,252,0,24,3,19,14,14,0,0,0,0,27,0,0,24,3,19,265,238,27
"N00002969",218,200,0,15,3,16,3,3,0,0,0,0,18,5,0,15,3,21,215,197,18
"N00002970",281,251,3,19,5,20,7,4,3,0,3,0,30,1,3,22,5,21,274,247,27
"N00002971",365,304,0,40,13,25,17,9,8,1,6,1,61,18,1,46,14,43,348,295,53
"N00002972",287,268,0,19,0,20,3,3,0,0,0,0,19,2,0,19,0,22,284,265,19
"N00002973",407,400,0,4,3,30,1,1,0,0,0,0,7,1,0,4,3,31,406,399,7
"N00002974",324,304,0,14,6,20,1,1,0,0,0,0,20,0,0,14,6,20,323,303,20
"N00002975",488,449,7,27,5,36,2,2,0,0,0,0,39,1,7,27,5,37,486,447,39
"N00002976",308,296,0,12,0,12,4,4,0,0,0,0,12,0,0,12,0,12,304,292,12
"N00002977",410,375,3,27,5,24,4,4,0,0,0,0,35,0,3,27,5,24,406,371,35
"N00002978",450,435,0,12,3,9,2,2,0,0,0,0,15,0,0,12,3,9,448,433,15
"N00002979",408,383,0,23,2,18,9,9,0,0,0,0,25,0,0,23,2,18,399,374,25
"N00002980",398,362,0,33,3,29,5,5,0,0,0,0,36,3,0,33,3,32,393,357,36
"N00002981",250,235,0,14,1,18,4,4,0,0,0,0,15,1,0,14,1,19,246,231,15
"N00002982",516,459,1,43,11,72,4,2,2,0,1,1,57,1,1,44,12,73,512,457,55
"N00002983",320,294,1,10,15,27,8,8,0,0,0,0,26,0,1,10,15,27,312,286,26
"N00002984",213,193,0,14,1,10,6,1,5,0,0,5,20,0,0,14,6,10,207,192,15
"N00002985",140,130,1,6,2,10,8,7,1,0,1,0,10,0,1,7,2,10,132,123,9
"N00002986",382,346,0,25,11,30,4,4,0,0,0,0,36,0,0,25,11,30,378,342,36
"N00002987",469,447,11,7,3,38,1,0,1,0,1,0,22,0,11,8,3,38,468,447,21
"N00002988",462,435,7,16,4,21,0,0,0,0,0,0,27,0,7,16,4,21,462,435,27
"N00002989",500,461,10,27,2,22,4,4,0,0,0,0,39,1,10,27,2,23,496,457,39
"N00002990",355,328,0,23,4,15,1,1,0,0,0,0,27,0,0,23,4,15,354,327,27
"N00002991",349,326,0,22,1,10,2,2,0,0,0,0,23,0,0,22,1,10,347,324,23
"N00002992",495,471,2,22,0,21,2,2,0,0,0,0,24,0,2,22,0,21,493,469,24
"N00002993",228,203,4,20,0,16,6,5,1,0,1,0,25,0,4,21,0,16,222,198,24
"N00002994",635,594,6,32,3,41,1,1,0,0,0,0,41,1,6,32,3,42,634,593,41
"N00002995",691,620,7,60,4,47,15,15,0,0,0,0,71,1,7,60,4,48,676,605,71
"N00002996",235,216,0,14,4,31,3,2,1,0,0,1,19,2,0,14,5,33,232,214,18
"N00002997",290,279,0,8,3,10,1,1,0,0,0,0,11,0,0,8,3,10,289,278,11
"N00002998",256,245,5,4,2,10,7,7,0,0,0,0,11,0,5,4,2,10,249,238,11
"N00002999",253,234,1,15,3,11,2,2,0,0,0,0,19,7,1,15,3,18,251,232,19
"N00003000",481,452,0,28,1,4,4,4,0,0,0,0,29,0,0,28,1,4,477,448,29
"N00003001",265,247,6,11,1,17,0,0,0,0,0,0,18,0,6,11,1,17,265,247,18
"N00003002",809,771,8,24,4,30,8,6,2,1,1,0,38,0,9,25,4,30,801,765,36
"N00003003",1353,1261,27,63,0,92,20,18,2,1,0,1,92,4,28,63,1,96,1333,1243,90
"N00003004",262,232,4,25,1,48,1,1,0,0,0,0,30,1,4,25,1,49,261,231,30
"N00003005",482,464,0,16,2,11,7,7,0,0,0,0,18,0,0,16,2,11,475,457,18
"N00003006",440,401,2,37,0,26,0,0,0,0,0,0,39,0,2,37,0,26,440,401,39
"N00003007",493,471,2,19,1,24,2,2,0,0,0,0,22,0,2,19,1,24,491,469,22
"N00003008",635,601,4,30,0,35,3,3,0,0,0,0,34,0,4,30,0,35,632,598,34
"N00003009",513,487,0,22,4,10,0,0,0,0,0,0,26,0,0,22,4,10,513,487,26
"N00003010",414,370,0,37,6,20,5,4,1,0,1,0,44,2,0,38,6,22,409,366,43
"N00003011",302,289,0,13,0,9,2,2,0,0,0,0,13,0,0,13,0,9,300,287,13
"N00003012",393,367,0,24,2,38,1,1,0,0,0,0,26,1,0,24,2,39,392,366,26
"N00003013",408,389,0,17,2,15,4,4,0,0,0,0,19,0,0,17,2,15,404,385,19
"N00003014",422,407,0,14,1,28,1,1,0,0,0,0,15,0,0,14,1,28,421,406,15
"N00003015",394,378,3,9,3,26,1,0,1,0,0,1,16,0,3,9,4,26,393,378,15
"N00003016",303,279,0,20,4,19,3,3,0,0,0,0,24,1,0,20,4,20,300,276,24
"N00003017",381,363,0,13,5,16,0,0,0,0,0,0,18,0,0,13,5,16,381,363,18
"N00003018",239,214,0,24,1,13,3,3,0,0,0,0,25,1,0,24,1,14,236,211,25
"N00003019",539,495,4,34,6,44,11,11,0,0,0,0,44,2,4,34,6,46,528,484,44
"N00003020",440,397,1,38,1,14,8,5,3,0,2,1,43,1,1,40,2,15,432,392,40
"N00003021",383,340,3,32,8,30,4,4,0,0,0,0,43,3,3,32,8,33,379,336,43
"N00003022",303,268,2,30,1,10,13,11,2,0,2,0,35,1,2,32,1,11,290,257,33
"N00003023",250,230,3,14,2,26,1,0,1,0,1,0,20,0,3,15,2,26,249,230,19
"N00003024",426,396,4,21,5,39,3,3,0,0,0,0,30,0,4,21,5,39,423,393,30
"N00003025",341,315,0,25,1,9,0,0,0,0,0,0,26,0,0,25,1,9,341,315,26
"N00003026",543,494,0,47,2,51,2,2,0,0,0,0,49,3,0,47,2,54,541,492,49
"N00003027",436,417,2,10,7,29,1,1,0,0,0,0,19,0,2,10,7,29,435,416,19
"N00003028",449,420,2,27,0,18,1,1,0,0,0,0,29,0,2,27,0,18,448,419,29
"N00003029",513,468,0,40,4,33,4,3,1,0,1,0,45,0,0,41,4,33,509,465,44
"N00003030",380,350,4,25,1,24,2,2,0,0,0,0,30,0,4,25,1,24,378,348,30
"N00003031",469,437,10,21,1,13,0,0,0,0,0,0,32,0,10,21,1,13,469,437,32
"N00003032",357,348,0,2,7,18,0,0,0,0,0,0,9,0,0,2,7,18,357,348,9
"N00003033",450,436,5,8,1,20,0,0,0,0,0,0,14,0,5,8,1,20,450,436,14
"N00003034",231,222,0,8,1,16,0,0,0,0,0,0,9,0,0,8,1,16,231,222,9
"N00003035",376,351,0,21,4,12,1,1,0,0,0,0,25,0,0,21,4,12,375,350,25
"N00003036",345,320,1,18,6,18,3,3,0,0,0,0,25,0,1,18,6,18,342,317,25
"N00003037",393,375,0,12,6,16,1,1,0,0,0,0,18,0,0,12,6,16,392,374,18
"N00003038",350,330,4,7,9,17,1,1,0,0,0,0,20,0,4,7,9,17,349,329,20
"N00003039",314,298,0,12,4,27,5,5,0,0,0,0,16,1,0,12,4,28,309,293,16
"N00003040",432,345,3,54,28,86,12,10,2,0,2,0,87,14,3,56,28,100,420,335,85
"N00003041",437,370,13,44,9,65,9,8,1,0,0,1,67,11,13,44,10,76,428,362,66
"N00003042",254,242,0,4,6,18,8,6,2,0,1,1,12,2,0,5,7,20,246,236,10
"N00003043",203,192,0,10,1,13,3,3,0,0,0,0,11,0,0,10,1,13,200,189,11
"N00003044",356,337,0,17,2,25,1,1,0,0,0,0,19,1,0,17,2,26,355,336,19
"N00003045",785,660,13,90,17,50,35,30,5,0,5,0,125,1,13,95,17,51,750,630,120
"N00003046",336,304,0,22,5,82,7,2,5,0,4,1,32,1,0,26,6,83,329,302,27
"N00003047",417,401,1,11,4,10,0,0,0,0,0,0,16,0,1,11,4,10,417,401,16
"N00003048",428,410,0,15,3,9,0,0,0,0,0,0,18,0,0,15,3,9,428,410,18
"N00003049",323,303,0,17,3,8,1,1,0,0,0,0,20,0,0,17,3,8,322,302,20
"N00003050",342,331,1,7,3,21,1,1,0,0,0,0,11,0,1,7,3,21,341,330,11
"N00003051",377,363,8,5,1,15,5,5,0,0,0,0,14,0,8,5,1,15,372,358,14
"N00003052",280,251,1,18,10,23,2,2,0,0,0,0,29,0,1,18,10,23,278,249,29
"N00003053",231,208,0,18,3,14,6,4,2,0,2,0,23,0,0,20,3,14,225,204,21
"N00003054",320,305,0,10,5,22,9,9,0,0,0,0,15,0,0,10,5,22,311,296,15
"N00003055",369,331,0,30,6,39,4,2,2,0,2,0,38,1,0,32,6,40,365,329,36
"N00003056",337,324,0,12,1,23,4,4,0,0,0,0,13,5,0,12,1,28,333,320,13
"N00003057",276,251,0,25,0,25,0,0,0,0,0,0,25,0,0,25,0,25,276,251,25
"N00003058",322,295,5,20,2,25,2,2,0,0,0,0,27,0,5,20,2,25,320,293,27
"N00003059",315,299,0,14,2,44,5,5,0,0,0,0,16,1,0,14,2,45,310,294,16
"N00003060",274,247,5,17,5,23,4,4,0,0,0,0,27,1,5,17,5,24,270,243,27
"N00003061",478,433,0,43,2,22,1,1,0,0,0,0,45,0,0,43,2,22,477,432,45
"N00003062",437,429,0,8,0,32,0,0,0,0,0,0,8,0,0,8,0,32,437,429,8
"N00003063",517,490,5,21,1,30,10,10,0,0,0,0,27,0,5,21,1,30,507,480,27
"N00003064",440,415,8,16,0,48,1,0,1,0,1,0,25,3,8,17,0,51,439,415,24
"N00003065",341,316,3,18,1,40,3,0,3,0,3,0,25,0,3,21,1,40,338,316,22
"N00003066",377,338,0,39,0,12,0,0,0,0,0,0,39,0,0,39,0,12,377,338,39
"N00003067",316,284,0,32,0,35,0,0,0,0,0,0,32,0,0,32,0,35,316,284,32
"N00003068",189,168,1,19,0,17,1,0,1,0,1,0,21,0,1,20,0,17,188,168,20
"N00003069",258,228,0,30,0,24,0,0,0,0,0,0,30,0,0,30,0,24,258,228,30
"N00003070",261,229,0,32,0,29,1,1,0,0,0,0,32,3,0,32,0,32,260,228,32
"N00003071",247,222,2,23,0,27,1,1,0,0,0,0,25,0,2,23,0,27,246,221,25
"N00003072",212,190,0,21,1,17,2,2,0,0,0,0,22,0,0,21,1,17,210,188,22
"N00003073",399,382,0,15,2,14,4,4,0,0,0,0,17,0,0,15,2,14,395,378,17
"N00003074",487,460,3,24,0,34,3,3,0,0,0,0,27,0,3,24,0,34,484,457,27
"N00003075",286,275,0,11,0,27,2,2,0,0,0,0,11,0,0,11,0,27,284,273,11
"N00003076",521,494,0,25,0,32,5,3,2,0,1,1,27,0,0,26,1,32,516,491,25
"N00003077",366,351,1,13,0,8,9,8,1,0,0,1,15,0,1,13,1,8,357,343,14
"N00003078",523,489,0,30,0,24,8,4,4,0,4,0,34,0,0,34,0,24,515,485,30
"N00003079",298,257,0,39,2,25,0,0,0,0,0,0,41,1,0,39,2,26,298,257,41
"N00003080",234,216,0,17,0,11,7,6,1,0,1,0,18,0,0,18,0,11,227,210,17
"N00003081",118,101,0,17,0,12,0,0,0,0,0,0,17,0,0,17,0,12,118,101,17
"N00003082",231,203,0,28,0,18,2,2,0,0,0,0,28,0,0,28,0,18,229,201,28
"N00003083",215,210,0,4,0,11,3,2,1,0,1,0,5,0,0,5,0,11,212,208,4
"N00003084",320,305,0,11,0,33,9,5,4,0,4,0,15,0,0,15,0,33,311,300,11
"N00003085",264,241,0,22,1,12,1,1,0,0,0,0,23,0,0,22,1,12,263,240,23
"N00003086",250,226,5,19,0,30,0,0,0,0,0,0,24,0,5,19,0,30,250,226,24
"N00003087",343,316,0,26,1,29,1,1,0,0,0,0,27,0,0,26,1,29,342,315,27
"N00003088",148,132,0,16,0,13,0,0,0,0,0,0,16,0,0,16,0,13,148,132,16
"N00003089",310,293,0,16,1,24,3,3,0,0,0,0,17,0,0,16,1,24,307,290,17
"N00003090",344,336,0,6,2,26,1,1,0,0,0,0,8,0,0,6,2,26,343,335,8
"N00003091",401,376,0,24,1,19,0,0,0,0,0,0,25,0,0,24,1,19,401,376,25
"N00003092",235,212,0,23,0,22,0,0,0,0,0,0,23,0,0,23,0,22,235,212,23
"N00003093",484,456,0,26,2,34,4,4,0,0,0,0,28,0,0,26,2,34,480,452,28
"N00003094",273,252,0,20,1,17,6,6,0,0,0,0,21,0,0,20,1,17,267,246,21
"N00003095",301,275,3,22,1,21,4,4,0,0,0,0,26,0,3,22,1,21,297,271,26
"N00003096",270,245,0,23,2,32,1,1,0,0,0,0,25,0,0,23,2,32,269,244,25
"N00003097",567,543,0,22,2,46,1,1,0,0,0,0,24,0,0,22,2,46,566,542,24
"N00003098",747,709,5,31,2,54,6,6,0,0,0,0,38,0,5,31,2,54,741,703,38
"N00003099",322,295,0,26,1,6,0,0,0,0,0,0,27,0,0,26,1,6,322,295,27
"N00003100",331,319,0,11,1,9,0,0,0,0,0,0,12,7,0,11,1,16,331,319,12
"N00003101",301,264,0,35,2,7,0,0,0,0,0,0,37,0,0,35,2,7,301,264,37
"N00003102",340,316,1,21,2,23,0,0,0,0,0,0,24,0,1,21,2,23,340,316,24
"N00003103",264,227,0,31,6,8,1,1,0,0,0,0,37,0,0,31,6,8,263,226,37
"N00003104",254,223,0,29,1,13,1,0,1,0,0,1,31,0,0,29,2,13,253,223,30
"N00003105",382,319,2,61,0,35,2,2,0,0,0,0,63,4,2,61,0,39,380,317,63
"N00003106",198,183,0,15,0,8,0,0,0,0,0,0,15,1,0,15,0,9,198,183,15
"N00003107",202,183,2,17,0,28,0,0,0,0,0,0,19,0,2,17,0,28,202,183,19
"N00003108",251,237,0,14,0,10,1,1,0,0,0,0,14,0,0,14,0,10,250,236,14
"N00003109",266,252,3,10,0,13,5,4,1,0,1,0,14,4,3,11,0,17,261,248,13
"N00003110",221,208,0,13,0,13,0,0,0,0,0,0,13,1,0,13,0,14,221,208,13
"N00003111",199,191,0,8,0,22,0,0,0,0,0,0,8,0,0,8,0,22,199,191,8
"N00003112",254,245,1,8,0,3,0,0,0,0,0,0,9,0,1,8,0,3,254,245,9
"N00003113",264,253,0,10,1,17,0,0,0,0,0,0,11,0,0,10,1,17,264,253,11
"N00003114",281,259,0,22,0,20,0,0,0,0,0,0,22,1,0,22,0,21,281,259,22
"N00003115",236,217,0,19,0,6,1,1,0,0,0,0,19,0,0,19,0,6,235,216,19
"N00003116",313,287,0,19,5,29,3,1,2,0,1,1,26,0,0,20,6,29,310,286,24
"N00003117",265,251,0,12,1,5,1,0,1,0,0,1,14,0,0,12,2,5,264,251,13
"N00003118",196,189,1,6,0,10,1,1,0,0,0,0,7,0,1,6,0,10,195,188,7
"N00003119",251,227,0,24,0,11,0,0,0,0,0,0,24,4,0,24,0,15,251,227,24
"N00003120",323,301,0,16,6,35,2,2,0,0,0,0,22,0,0,16,6,35,321,299,22
"N00003121",315,292,3,20,0,31,0,0,0,0,0,0,23,0,3,20,0,31,315,292,23
"N00003122",253,238,0,14,0,10,5,4,1,0,1,0,15,0,0,15,0,10,248,234,14
"N00003123",364,346,4,13,1,6,1,1,0,0,0,0,18,0,4,13,1,6,363,345,18
"N00003124",314,286,4,23,1,29,1,1,0,0,0,0,28,0,4,23,1,29,313,285,28
"N00003125",292,273,7,10,2,13,0,0,0,0,0,0,19,0,7,10,2,13,292,273,19
"N00003126",447,432,0,14,1,34,1,1,0,0,0,0,15,0,0,14,1,34,446,431,15
"N00003127",434,403,0,31,0,32,1,1,0,0,0,0,31,0,0,31,0,32,433,402,31
"N00003128",283,267,0,16,0,11,1,1,0,0,0,0,16,0,0,16,0,11,282,266,16
"N00003129",322,312,0,7,3,22,0,0,0,0,0,0,10,0,0,7,3,22,322,312,10
"N00003130",302,297,0,5,0,13,0,0,0,0,0,0,5,6,0,5,0,19,302,297,5
"N00003131",823,802,0,21,0,27,0,0,0,0,0,0,21,0,0,21,0,27,823,802,21
"N00003132",297,274,1,22,0,32,0,0,0,0,0,0,23,0,1,22,0,32,297,274,23
"N00003133",379,359,0,18,2,36,4,4,0,0,0,0,20,1,0,18,2,37,375,355,20
"N00003134",298,270,4,24,0,21,1,1,0,0,0,0,28,0,4,24,0,21,297,269,28
"N00003135",149,140,0,9,0,2,0,0,0,0,0,0,9,0,0,9,0,2,149,140,9
"N00003136",369,334,0,31,3,59,3,2,1,0,1,0,35,0,0,32,3,59,366,332,34
"N00003137",320,276,1,37,0,26,10,4,6,0,5,1,44,0,1,42,1,26,310,272,38
"N00003138",296,267,3,26,0,26,0,0,0,0,0,0,29,1,3,26,0,27,296,267,29
"N00003139",414,404,0,8,2,28,0,0,0,0,0,0,10,0,0,8,2,28,414,404,10
"N00003140",330,321,1,7,1,4,2,2,0,0,0,0,9,0,1,7,1,4,328,319,9
"N00003141",357,343,0,13,1,25,0,0,0,0,0,0,14,1,0,13,1,26,357,343,14
"N00003142",896,843,3,47,3,35,7,7,0,0,0,0,53,1,3,47,3,36,889,836,53
"N00003143",293,252,2,38,0,24,5,4,1,0,1,0,41,0,2,39,0,24,288,248,40
"N00003144",278,261,0,16,1,7,0,0,0,0,0,0,17,0,0,16,1,7,278,261,17
"N00003145",1350,1207,9,133,0,111,2,1,1,0,1,0,143,1,9,134,0,112,1348,1206,142
"N00003146",403,356,0,44,0,29,9,6,3,0,3,0,47,0,0,47,0,29,394,350,44
"N00003147",1029,931,6,91,1,48,6,6,0,0,0,0,98,0,6,91,1,48,1023,925,98
"N00003148",327,319,0,7,1,25,1,1,0,0,0,0,8,0,0,7,1,25,326,318,8
"N00003149",551,502,3,46,0,26,0,0,0,0,0,0,49,1,3,46,0,27,551,502,49
"N00003150",368,347,5,16,0,16,2,2,0,0,0,0,21,0,5,16,0,16,366,345,21
"N00003151",269,249,1,18,1,16,0,0,0,0,0,0,20,0,1,18,1,16,269,249,20
"N00003152",399,379,0,19,1,39,1,1,0,0,0,0,20,0,0,19,1,39,398,378,20
"N00003153",369,352,2,15,0,26,0,0,0,0,0,0,17,0,2,15,0,26,369,352,17
"N00003154",365,357,0,8,0,19,1,1,0,0,0,0,8,0,0,8,0,19,364,356,8
"N00003155",249,217,0,28,3,24,1,0,1,0,1,0,32,0,0,29,3,24,248,217,31
"N00003156",232,198,0,29,0,15,14,9,5,0,3,2,34,0,0,32,2,15,218,189,29
"N00003157",237,212,0,20,2,14,6,3,3,0,3,0,25,0,0,23,2,14,231,209,22
"N00003158",228,213,0,15,0,14,0,0,0,0,0,0,15,0,0,15,0,14,228,213,15
"N00003159",410,392,2,16,0,34,11,11,0,0,0,0,18,1,2,16,0,35,399,381,18
"N00003160",237,224,2,9,2,21,0,0,0,0,0,0,13,4,2,9,2,25,237,224,13
"N00003161",1523,1433,0,82,6,91,11,9,2,0,2,0,90,0,0,84,6,91,1512,1424,88
"N00003162",968,870,8,88,2,98,13,13,0,0,0,0,98,2,8,88,2,100,955,857,98
"N00003163",462,440,2,19,0,22,1,0,1,0,1,0,22,0,2,20,0,22,461,440,21
"N00003164",542,501,3,38,0,18,0,0,0,0,0,0,41,0,3,38,0,18,542,501,41
"N00003165",314,305,0,9,0,25,1,1,0,0,0,0,9,1,0,9,0,26,313,304,9
"N00003166",558,521,0,31,1,32,10,5,5,0,4,1,37,1,0,35,2,33,548,516,32
"N00003167",286,264,0,22,0,5,0,0,0,0,0,0,22,0,0,22,0,5,286,264,22
"N00003168",377,353,3,17,1,36,4,1,3,0,0,3,24,5,3,17,4,41,373,352,21
"N00003169",331,308,0,21,2,45,2,2,0,0,0,0,23,0,0,21,2,45,329,306,23
"N00003170",759,685,6,67,0,54,7,6,1,0,1,0,74,0,6,68,0,54,752,679,73
"N00003171",284,257,1,25,1,40,4,4,0,0,0,0,27,0,1,25,1,40,280,253,27
"N00003172",245,226,1,17,1,24,0,0,0,0,0,0,19,0,1,17,1,24,245,226,19
"N00003173",302,262,0,38,2,51,5,5,0,0,0,0,40,2,0,38,2,53,297,257,40
"N00003174",233,205,0,21,0,40,7,0,7,0,0,7,28,1,0,21,7,41,226,205,21
"N00003175",358,326,2,26,3,28,5,4,1,0,1,0,32,2,2,27,3,30,353,322,31
"N00003176",478,434,3,34,7,38,0,0,0,0,0,0,44,0,3,34,7,38,478,434,44
"N00003177",673,647,0,23,3,35,3,3,0,0,0,0,26,0,0,23,3,35,670,644,26
"N00003178",328,307,0,21,0,15,0,0,0,0,0,0,21,0,0,21,0,15,328,307,21
"N00003179",543,500,1,38,2,26,6,4,2,0,2,0,43,2,1,40,2,28,537,496,41
"N00003180",240,226,0,14,0,15,0,0,0,0,0,0,14,0,0,14,0,15,240,226,14
"N00003181",307,294,0,11,2,29,4,4,0,0,0,0,13,0,0,11,2,29,303,290,13
"N00003182",297,289,0,8,0,10,2,2,0,0,0,0,8,0,0,8,0,10,295,287,8
"N00003183",431,407,0,23,0,20,9,8,1,0,0,1,24,0,0,23,1,20,422,399,23
"N00003184",326,288,2,36,0,36,5,5,0,0,0,0,38,0,2,36,0,36,321,283,38
"N00003185",250,232,0,18,0,20,0,0,0,0,0,0,18,0,0,18,0,20,250,232,18
"N00003186",300,256,2,41,1,30,6,6,0,0,0,0,44,0,2,41,1,30,294,250,44
"N00003187",336,300,0,36,0,28,1,1,0,0,0,0,36,0,0,36,0,28,335,299,36
"N00003188",612,585,1,25,1,13,1,1,0,0,0,0,27,0,1,25,1,13,611,584,27
"N00003189",407,384,1,21,1,18,1,1,0,0,0,0,23,0,1,21,1,18,406,383,23
"N00003190",409,400,2,5,2,10,1,1,0,0,0,0,9,0,2,5,2,10,408,399,9
"N00003191",368,361,0,5,2,21,1,1,0,0,0,0,7,0,0,5,2,21,367,360,7
"N00003192",410,383,1,23,3,39,1,1,0,0,0,0,27,1,1,23,3,40,409,382,27
"N00003193",378,370,1,6,1,28,0,0,0,0,0,0,8,1,1,6,1,29,378,370,8
"N00003194",426,407,4,14,1,18,0,0,0,0,0,0,19,0,4,14,1,18,426,407,19
"N00003195",545,500,1,41,3,15,0,0,0,0,0,0,45,0,1,41,3,15,545,500,45
"N00003196",439,419,1,19,0,58,4,4,0,0,0,0,20,1,1,19,0,59,435,415,20
"N00003197",347,332,0,15,0,21,1,1,0,0,0,0,15,0,0,15,0,21,346,331,15
"N00003198",314,290,0,23,1,22,5,5,0,0,0,0,24,0,0,23,1,22,309,285,24
"N00003199",471,461,0,9,1,14,0,0,0,0,0,0,10,0,0,9,1,14,471,461,10
"N00003200",399,382,0,15,1,45,2,1,1,0,1,0,17,0,0,16,1,45,397,381,16
"N00003201",444,405,6,33,0,36,0,0,0,0,0,0,39,0,6,33,0,36,444,405,39
"N00003202",436,420,0,12,1,29,3,0,3,0,3,0,16,0,0,15,1,29,433,420,13
"N00003203",356,340,0,12,0,14,5,1,4,0,4,0,16,0,0,16,0,14,351,339,12
"N00003204",520,468,8,43,1,32,2,2,0,0,0,0,52,0,8,43,1,32,518,466,52
"N00003205",507,485,2,15,4,44,6,5,1,0,0,1,22,0,2,15,5,44,501,480,21
"N00003206",318,302,0,14,2,15,0,0,0,0,0,0,16,0,0,14,2,15,318,302,16
"N00003207",408,389,0,16,3,30,0,0,0,0,0,0,19,2,0,16,3,32,408,389,19
"N00003208",393,372,0,21,0,10,0,0,0,0,0,0,21,0,0,21,0,10,393,372,21
"N00003209",1247,775,20,426,17,49,28,19,9,0,8,1,472,2,20,434,18,51,1219,756,463
"N00003210",278,247,0,26,5,35,7,7,0,0,0,0,31,0,0,26,5,35,271,240,31
"N00003211",266,248,0,15,1,65,6,4,2,0,2,0,18,0,0,17,1,65,260,244,16
"N00003212",355,314,2,39,0,38,4,4,0,0,0,0,41,1,2,39,0,39,351,310,41
"N00003213",237,200,2,27,6,26,3,1,2,0,2,0,37,1,2,29,6,27,234,199,35
"N00003214",219,189,0,27,3,15,3,3,0,0,0,0,30,2,0,27,3,17,216,186,30
"N00003215",261,244,0,16,0,19,8,7,1,0,0,1,17,0,0,16,1,19,253,237,16
"N00003216",384,365,0,17,2,19,1,1,0,0,0,0,19,4,0,17,2,23,383,364,19
"N00003217",325,304,1,19,1,16,3,3,0,0,0,0,21,0,1,19,1,16,322,301,21
"N00003218",534,495,0,38,1,34,0,0,0,0,0,0,39,0,0,38,1,34,534,495,39
"N00003219",810,603,3,188,5,112,25,14,11,0,7,4,207,1,3,195,9,113,785,589,196
"N00003220",354,342,0,12,0,32,0,0,0,0,0,0,12,0,0,12,0,32,354,342,12
"N00003221",285,272,1,12,0,10,0,0,0,0,0,0,13,0,1,12,0,10,285,272,13
"N00003222",329,295,0,33,1,34,0,0,0,0,0,0,34,0,0,33,1,34,329,295,34
"N00003223",290,271,0,19,0,33,0,0,0,0,0,0,19,0,0,19,0,33,290,271,19
"N00003224",257,232,0,24,1,33,2,2,0,0,0,0,25,0,0,24,1,33,255,230,25
"N00003225",291,276,0,15,0,22,2,2,0,0,0,0,15,0,0,15,0,22,289,274,15
"N00003226",269,246,0,18,5,10,7,7,0,0,0,0,23,0,0,18,5,10,262,239,23
"N00003227",228,206,0,20,2,18,0,0,0,0,0,0,22,0,0,20,2,18,228,206,22
"N00003228",318,272,2,41,3,34,0,0,0,0,0,0,46,0,2,41,3,34,318,272,46
"N00003229",217,203,1,10,3,9,0,0,0,0,0,0,14,0,1,10,3,9,217,203,14
"N00003230",218,190,1,27,0,44,3,3,0,0,0,0,28,1,1,27,0,45,215,187,28
"N00003231",179,126,1,51,1,30,0,0,0,0,0,0,53,0,1,51,1,30,179,126,53
"N00003232",480,463,6,11,0,17,1,1,0,0,0,0,17,0,6,11,0,17,479,462,17
"N00003233",375,359,0,16,0,19,0,0,0,0,0,0,16,0,0,16,0,19,375,359,16
"N00003234",546,526,6,12,2,20,4,4,0,0,0,0,20,0,6,12,2,20,542,522,20
"N00003235",568,542,0,26,0,16,0,0,0,0,0,0,26,0,0,26,0,16,568,542,26
"N00003236",456,431,4,20,0,37,1,0,1,0,0,1,25,0,4,20,1,37,455,431,24
"N00003237",995,926,11,54,4,45,3,3,0,0,0,0,69,0,11,54,4,45,992,923,69
"N00003238",569,556,0,13,0,22,1,1,0,0,0,0,13,0,0,13,0,22,568,555,13
"N00003239",438,431,0,6,1,17,0,0,0,0,0,0,7,0,0,6,1,17,438,431,7
"N00003240",792,680,8,95,6,94,11,8,3,0,3,0,112,2,8,98,6,96,781,672,109
"N00003241",377,361,0,15,1,14,5,5,0,0,0,0,16,0,0,15,1,14,372,356,16
"N00003242",319,312,0,7,0,18,1,1,0,0,0,0,7,0,0,7,0,18,318,311,7
"N00003243",444,407,0,37,0,20,0,0,0,0,0,0,37,1,0,37,0,21,444,407,37
"N00003244",331,323,0,8,0,30,3,3,0,0,0,0,8,0,0,8,0,30,328,320,8
"N00003245",476,433,3,39,0,12,3,2,1,0,1,0,43,0,3,40,0,12,473,431,42
"N00003246",810,751,7,51,1,75,1,1,0,0,0,0,59,1,7,51,1,76,809,750,59
"N00003247",820,755,1,61,1,44,7,5,2,0,0,2,65,0,1,61,3,44,813,750,63
"N00003248",347,333,0,9,4,15,4,3,1,0,1,0,14,0,0,10,4,15,343,330,13
"N00003249",412,387,0,21,4,18,0,0,0,0,0,0,25,0,0,21,4,18,412,387,25
"N00003250",309,290,0,12,2,21,5,0,5,0,5,0,19,1,0,17,2,22,304,290,14
"N00003251",308,290,0,18,0,11,2,2,0,0,0,0,18,3,0,18,0,14,306,288,18
"N00003252",346,293,1,52,0,45,0,0,0,0,0,0,53,5,1,52,0,50,346,293,53
"N00003253",299,279,0,16,2,12,2,0,2,0,2,0,20,0,0,18,2,12,297,279,18
"N00003254",247,238,0,9,0,13,3,3,0,0,0,0,9,0,0,9,0,13,244,235,9
"N00003255",354,330,0,20,0,16,9,5,4,0,4,0,24,3,0,24,0,19,345,325,20
"N00003256",370,342,0,25,2,36,6,5,1,0,1,0,28,0,0,26,2,36,364,337,27
"N00003257",344,332,0,12,0,22,1,1,0,0,0,0,12,0,0,12,0,22,343,331,12
"N00003258",547,465,0,82,0,31,9,9,0,0,0,0,82,0,0,82,0,31,538,456,82
"N00003259",323,316,0,7,0,20,8,8,0,0,0,0,7,0,0,7,0,20,315,308,7
"N00003260",384,360,0,22,2,25,9,9,0,0,0,0,24,0,0,22,2,25,375,351,24
"N00003261",456,430,0,23,1,21,17,15,2,0,2,0,26,0,0,25,1,21,439,415,24
"N00003262",364,332,0,32,0,15,2,2,0,0,0,0,32,0,0,32,0,15,362,330,32
"N00003263",417,396,0,16,5,20,3,3,0,0,0,0,21,0,0,16,5,20,414,393,21
"N00003264",418,410,1,6,0,9,2,1,1,0,1,0,8,0,1,7,0,9,416,409,7
"N00003265",381,368,1,10,2,24,0,0,0,0,0,0,13,0,1,10,2,24,381,368,13
"N00003266",356,338,0,18,0,18,0,0,0,0,0,0,18,0,0,18,0,18,356,338,18
"N00003267",408,392,0,14,1,24,1,0,1,0,1,0,16,0,0,15,1,24,407,392,15
"N00003268",344,343,0,1,0,21,4,4,0,0,0,0,1,0,0,1,0,21,340,339,1
"N00003269",354,346,1,6,1,23,2,2,0,0,0,0,8,0,1,6,1,23,352,344,8
"N00003270",330,313,0,14,3,10,2,2,0,0,0,0,17,0,0,14,3,10,328,311,17
"N00003271",603,451,0,151,1,38,4,4,0,0,0,0,152,1,0,151,1,39,599,447,152
"N00003272",613,545,0,61,2,37,19,14,5,0,5,0,68,0,0,66,2,37,594,531,63
"N00003273",832,789,0,38,1,58,18,14,4,0,4,0,43,3,0,42,1,61,814,775,39
"N00003274",277,265,0,12,0,28,1,1,0,0,0,0,12,2,0,12,0,30,276,264,12
"N00003275",202,193,0,8,1,9,9,9,0,0,0,0,9,0,0,8,1,9,193,184,9
"N00003276",557,437,0,116,3,22,24,23,1,0,1,0,120,2,0,117,3,24,533,414,119
"N00003277",457,433,0,17,5,32,8,6,2,0,2,0,24,2,0,19,5,34,449,427,22
"N00003278",430,377,0,41,2,45,23,13,10,1,4,5,53,2,1,45,7,47,407,364,43
"N00003279",239,222,0,17,0,21,1,1,0,0,0,0,17,0,0,17,0,21,238,221,17
"N00003280",895,757,1,127,4,41,14,8,6,0,5,1,138,4,1,132,5,45,881,749,132
"N00003281",355,339,0,14,0,11,13,11,2,0,2,0,16,0,0,16,0,11,342,328,14
"N00003282",2112,1899,4,190,7,122,47,35,12,0,11,1,213,6,4,201,8,128,2065,1864,201
"N00003283",253,228,0,21,3,26,11,10,1,0,1,0,25,0,0,22,3,26,242,218,24
"N00003284",284,233,0,47,4,47,5,5,0,0,0,0,51,0,0,47,4,47,279,228,51
"N00003285",241,224,2,15,0,11,1,1,0,0,0,0,17,0,2,15,0,11,240,223,17
"N00003286",250,226,0,22,0,21,3,1,2,0,1,1,24,0,0,23,1,21,247,225,22
"N00003287",257,246,0,10,1,17,0,0,0,0,0,0,11,1,0,10,1,18,257,246,11
"N00003288",287,263,0,24,0,28,5,5,0,0,0,0,24,0,0,24,0,28,282,258,24
"N00003289",311,289,0,19,1,16,4,2,2,0,2,0,22,0,0,21,1,16,307,287,20
"N00003290",499,477,0,18,0,25,15,11,4,0,3,1,22,1,0,21,1,26,484,466,18
"N00003291",694,629,0,62,3,55,9,9,0,0,0,0,65,0,0,62,3,55,685,620,65
"N00003292",299,277,1,19,1,11,13,12,1,0,0,1,22,0,1,19,2,11,286,265,21
"N00003293",350,339,0,5,3,28,5,2,3,0,3,0,11,0,0,8,3,28,345,337,8
"N00003294",344,325,0,16,0,18,6,3,3,0,3,0,19,1,0,19,0,19,338,322,16
"N00003295",871,831,0,39,0,71,22,21,1,0,1,0,40,10,0,40,0,81,849,810,39
"N00003296",373,327,2,42,1,32,2,1,1,0,1,0,46,12,2,43,1,44,371,326,45
"N00003297",402,389,0,13,0,20,2,2,0,0,0,0,13,1,0,13,0,21,400,387,13
"N00003298",616,582,4,30,0,40,18,18,0,0,0,0,34,1,4,30,0,41,598,564,34
"N00003299",720,679,0,41,0,54,6,6,0,0,0,0,41,2,0,41,0,56,714,673,41
"N00003300",254,236,0,18,0,42,2,2,0,0,0,0,18,0,0,18,0,42,252,234,18
"N00003301",308,284,0,22,2,12,1,1,0,0,0,0,24,0,0,22,2,12,307,283,24
"N00003302",498,472,0,25,0,47,6,5,1,0,1,0,26,0,0,26,0,47,492,467,25
"N00003303",396,375,0,21,0,35,7,7,0,0,0,0,21,0,0,21,0,35,389,368,21
"N00003304",293,280,0,13,0,22,2,2,0,0,0,0,13,0,0,13,0,22,291,278,13
"N00003305",474,411,0,57,0,32,12,6,6,0,6,0,63,0,0,63,0,32,462,405,57
"N00003306",700,636,1,59,1,25,11,8,3,0,0,3,64,0,1,59,4,25,689,628,61
"N00003307",562,527,1,21,4,37,21,12,9,0,7,2,35,1,1,28,6,38,541,515,26
"N00003308",3075,2878,7,189,1,121,30,30,0,0,0,0,197,0,7,189,1,121,3045,2848,197
"N00003309",303,290,1,12,0,4,6,6,0,0,0,0,13,0,1,12,0,4,297,284,13
"N00003310",321,300,0,21,0,27,0,0,0,0,0,0,21,0,0,21,0,27,321,300,21
"N00003311",1274,1234,1,37,0,31,11,9,2,0,2,0,40,2,1,39,0,33,1263,1225,38
"N00003312",423,414,0,9,0,16,2,2,0,0,0,0,9,0,0,9,0,16,421,412,9
"N00003313",1435,1211,13,193,10,117,63,55,8,0,7,1,224,14,13,200,11,131,1372,1156,216
"N00003314",777,689,0,75,4,61,21,12,9,0,8,1,88,9,0,83,5,70,756,677,79
"N00003315",201,198,0,3,0,10,1,1,0,0,0,0,3,0,0,3,0,10,200,197,3
"N00003316",393,370,0,23,0,39,1,1,0,0,0,0,23,0,0,23,0,39,392,369,23
"N00003317",333,323,0,9,0,17,4,3,1,0,1,0,10,0,0,10,0,17,329,320,9
"N00003318",965,924,2,29,10,58,1,1,0,0,0,0,41,1,2,29,10,59,964,923,41
"N00003319",372,335,3,31,3,24,1,1,0,0,0,0,37,0,3,31,3,24,371,334,37
"N00003320",304,299,0,4,1,21,0,0,0,0,0,0,5,0,0,4,1,21,304,299,5
"N00003321",411,391,0,19,1,18,0,0,0,0,0,0,20,0,0,19,1,18,411,391,20
"N00003322",410,393,0,17,0,25,2,2,0,0,0,0,17,0,0,17,0,25,408,391,17
"N00003323",455,435,1,14,5,15,0,0,0,0,0,0,20,0,1,14,5,15,455,435,20
"N00003324",358,332,0,26,0,31,2,2,0,0,0,0,26,0,0,26,0,31,356,330,26
"N00003325",429,409,0,14,3,25,6,3,3,0,0,3,20,0,0,14,6,25,423,406,17
"N00003326",661,566,8,79,2,47,9,3,6,0,6,0,95,3,8,85,2,50,652,563,89
"N00003327",375,327,0,46,1,21,5,4,1,0,1,0,48,0,0,47,1,21,370,323,47
"N00003328",214,188,2,23,0,38,7,6,1,0,1,0,26,0,2,24,0,38,207,182,25
"N00003329",338,318,1,19,0,29,0,0,0,0,0,0,20,1,1,19,0,30,338,318,20
"N00003330",328,319,0,8,1,14,14,14,0,0,0,0,9,2,0,8,1,16,314,305,9
"N00003331",442,426,0,14,1,26,3,2,1,0,1,0,16,5,0,15,1,31,439,424,15
"N00003332",395,369,0,23,2,19,1,0,1,0,0,1,26,0,0,23,3,19,394,369,25
"N00003333",305,288,0,17,0,15,2,2,0,0,0,0,17,0,0,17,0,15,303,286,17
"N00003334",321,311,0,10,0,13,3,3,0,0,0,0,10,0,0,10,0,13,318,308,10
"N00003335",244,217,0,27,0,16,1,1,0,0,0,0,27,0,0,27,0,16,243,216,27
"N00003336",402,365,0,36,0,10,5,4,1,0,1,0,37,0,0,37,0,10,397,361,36
"N00003337",302,268,0,33,0,34,8,7,1,0,1,0,34,14,0,34,0,48,294,261,33
"N00003338",248,235,0,12,1,21,0,0,0,0,0,0,13,0,0,12,1,21,248,235,13
"N00003339",414,357,0,51,0,53,21,15,6,0,3,3,57,0,0,54,3,53,393,342,51
"N00003340",272,239,3,27,0,14,4,1,3,0,3,0,33,0,3,30,0,14,268,238,30
"N00003341",302,298,0,4,0,27,8,8,0,0,0,0,4,0,0,4,0,27,294,290,4
"N00003342",367,338,0,29,0,30,3,3,0,0,0,0,29,0,0,29,0,30,364,335,29
"N00003343",294,271,0,21,0,14,7,5,2,0,2,0,23,0,0,23,0,14,287,266,21
"N00003344",288,253,0,33,2,19,0,0,0,0,0,0,35,0,0,33,2,19,288,253,35
"N00003345",360,348,0,10,2,16,0,0,0,0,0,0,12,0,0,10,2,16,360,348,12
"N00003346",480,470,0,10,0,13,0,0,0,0,0,0,10,0,0,10,0,13,480,470,10
"N00003347",453,443,0,9,1,18,0,0,0,0,0,0,10,0,0,9,1,18,453,443,10
"N00003348",599,550,0,39,10,44,1,1,0,0,0,0,49,0,0,39,10,44,598,549,49
"N00003349",1063,975,8,78,2,71,8,8,0,0,0,0,88,0,8,78,2,71,1055,967,88
"N00003350",595,571,1,22,1,41,5,5,0,0,0,0,24,0,1,22,1,41,590,566,24
"N00003351",413,403,5,5,0,15,0,0,0,0,0,0,10,0,5,5,0,15,413,403,10
"N00003352",461,430,3,27,1,28,0,0,0,0,0,0,31,0,3,27,1,28,461,430,31
"N00003353",414,393,0,18,1,48,6,4,2,0,0,2,21,0,0,18,3,48,408,389,19
"N00003354",508,493,0,13,2,21,9,9,0,0,0,0,15,0,0,13,2,21,499,484,15
"N00003355",492,479,0,13,0,25,2,2,0,0,0,0,13,0,0,13,0,25,490,477,13
"N00003356",618,590,4,24,0,32,13,13,0,0,0,0,28,0,4,24,0,32,605,577,28
"N00003357",336,327,0,8,1,12,2,2,0,0,0,0,9,0,0,8,1,12,334,325,9
"N00003358",423,407,0,16,0,22,4,4,0,0,0,0,16,0,0,16,0,22,419,403,16
"N00003359",374,359,1,12,2,34,0,0,0,0,0,0,15,0,1,12,2,34,374,359,15
"N00003360",212,192,0,17,1,24,8,6,2,0,2,0,20,1,0,19,1,25,204,186,18
"N00003361",279,245,0,30,0,27,8,4,4,0,0,4,34,0,0,30,4,27,271,241,30
"N00003362",358,339,1,18,0,25,8,8,0,0,0,0,19,0,1,18,0,25,350,331,19
"N00003363",706,677,0,29,0,50,10,10,0,0,0,0,29,4,0,29,0,54,696,667,29
"N00003364",408,348,0,57,3,62,11,11,0,0,0,0,60,9,0,57,3,71,397,337,60
"N00003365",470,442,0,24,3,42,14,13,1,0,1,0,28,3,0,25,3,45,456,429,27
"N00003366",293,270,0,23,0,37,8,8,0,0,0,0,23,1,0,23,0,38,285,262,23
"N00003367",328,312,0,16,0,16,10,10,0,0,0,0,16,0,0,16,0,16,318,302,16
"N00003368",289,223,3,48,4,42,16,5,11,0,8,3,66,0,3,56,7,42,273,218,55
"N00003369",284,217,0,61,2,28,9,5,4,0,4,0,67,1,0,65,2,29,275,212,63
"N00003370",283,260,2,13,4,22,8,4,4,0,0,4,23,0,2,13,8,22,275,256,19
"N00003371",321,275,2,40,0,43,16,12,4,0,2,2,46,18,2,42,2,61,305,263,42
"N00003372",351,316,1,29,3,29,17,15,2,0,2,0,35,2,1,31,3,31,334,301,33
"N00003373",309,280,0,25,3,17,2,1,1,0,0,1,29,0,0,25,4,17,307,279,28
"N00003374",272,259,0,6,4,16,10,7,3,0,3,0,13,0,0,9,4,16,262,252,10
"N00003375",243,205,0,31,5,23,3,1,2,0,2,0,38,0,0,33,5,23,240,204,36
"N00003376",300,267,0,25,3,28,14,9,5,0,5,0,33,1,0,30,3,29,286,258,28
"N00003377",252,210,1,40,1,16,18,18,0,0,0,0,42,0,1,40,1,16,234,192,42
"N00003378",244,220,0,21,2,22,1,0,1,0,1,0,24,0,0,22,2,22,243,220,23
"N00003379",283,261,0,18,4,34,3,3,0,0,0,0,22,2,0,18,4,36,280,258,22
"N00003380",338,309,0,28,0,12,8,7,1,0,1,0,29,0,0,29,0,12,330,302,28
"N00003381",330,293,0,34,1,28,2,0,2,0,2,0,37,1,0,36,1,29,328,293,35
"N00003382",225,205,0,16,3,25,3,2,1,0,0,1,20,0,0,16,4,25,222,203,19
"N00003383",263,247,0,16,0,13,10,10,0,0,0,0,16,0,0,16,0,13,253,237,16
"N00003384",405,383,0,18,1,42,11,8,3,0,3,0,22,1,0,21,1,43,394,375,19
"N00003385",448,409,0,38,1,23,14,14,0,0,0,0,39,0,0,38,1,23,434,395,39
"N00003386",369,343,1,24,0,26,8,7,1,0,1,0,26,0,1,25,0,26,361,336,25
"N00003387",341,315,0,26,0,22,0,0,0,0,0,0,26,0,0,26,0,22,341,315,26
"N00003388",346,318,0,27,1,28,2,2,0,0,0,0,28,0,0,27,1,28,344,316,28
"N00003389",376,361,2,11,2,14,12,12,0,0,0,0,15,1,2,11,2,15,364,349,15
"N00003390",358,345,0,10,2,17,1,0,1,0,1,0,13,0,0,11,2,17,357,345,12
"N00003391",372,339,3,29,0,12,1,0,1,0,1,0,33,0,3,30,0,12,371,339,32
"N00003392",434,414,0,14,6,25,2,2,0,0,0,0,20,0,0,14,6,25,432,412,20
"N00003393",424,385,0,31,8,20,0,0,0,0,0,0,39,0,0,31,8,20,424,385,39
"N00003394",392,359,1,29,1,23,2,0,2,0,0,2,33,0,1,29,3,23,390,359,31
"N00003395",279,231,1,41,4,21,3,1,2,0,1,1,48,0,1,42,5,21,276,230,46
"N00003396",436,420,0,14,2,26,0,0,0,0,0,0,16,0,0,14,2,26,436,420,16
"N00003397",258,243,2,13,0,0,3,3,0,0,0,0,15,0,2,13,0,0,255,240,15
"N00003398",378,365,0,13,0,20,0,0,0,0,0,0,13,0,0,13,0,20,378,365,13
"N00003399",416,391,1,23,1,42,11,11,0,0,0,0,25,1,1,23,1,43,405,380,25
"N00003400",424,404,0,19,1,25,11,11,0,0,0,0,20,0,0,19,1,25,413,393,20
"N00003401",369,359,0,6,3,16,1,0,1,0,1,0,10,0,0,7,3,16,368,359,9
"N00003402",411,387,0,23,1,21,2,2,0,0,0,0,24,0,0,23,1,21,409,385,24
"N00003403",269,256,0,13,0,21,6,6,0,0,0,0,13,0,0,13,0,21,263,250,13
"N00003404",296,283,2,9,2,15,0,0,0,0,0,0,13,0,2,9,2,15,296,283,13
"N00003405",343,323,0,19,1,31,0,0,0,0,0,0,20,0,0,19,1,31,343,323,20
"N00003406",384,351,0,27,1,48,15,10,5,0,5,0,33,0,0,32,1,48,369,341,28
"N00003407",558,508,3,45,0,26,18,16,2,0,2,0,50,0,3,47,0,26,540,492,48
"N00003408",531,407,3,109,4,31,8,0,8,4,4,0,124,2,7,113,4,33,523,407,116
"N00003409",341,289,0,49,2,8,5,4,1,0,1,0,52,3,0,50,2,11,336,285,51
"N00003410",652,579,3,56,6,73,23,15,8,0,8,0,73,0,3,64,6,73,629,564,65
"N00003411",283,259,0,22,0,31,5,3,2,0,2,0,24,0,0,24,0,31,278,256,22
"N00003412",292,274,0,18,0,30,3,3,0,0,0,0,18,1,0,18,0,31,289,271,18
"N00003413",271,246,0,20,5,33,0,0,0,0,0,0,25,1,0,20,5,34,271,246,25
"N00003414",377,310,0,56,6,60,8,3,5,0,5,0,67,0,0,61,6,60,369,307,62
"N00003415",309,287,0,21,1,27,0,0,0,0,0,0,22,0,0,21,1,27,309,287,22
"N00003416",300,276,0,24,0,13,1,1,0,0,0,0,24,2,0,24,0,15,299,275,24
"N00003417",253,213,0,39,1,19,2,2,0,0,0,0,40,4,0,39,1,23,251,211,40
"N00003418",254,237,0,15,1,28,4,3,1,0,0,1,17,0,0,15,2,28,250,234,16
"N00003419",314,302,0,12,0,16,16,16,0,0,0,0,12,7,0,12,0,23,298,286,12
"N00003420",299,276,0,19,4,26,9,9,0,0,0,0,23,1,0,19,4,27,290,267,23
"N00003421",295,273,0,20,1,18,6,5,1,0,0,1,22,0,0,20,2,18,289,268,21
"N00003422",632,554,1,75,2,31,22,22,0,0,0,0,78,3,1,75,2,34,610,532,78
"N00003423",516,454,0,43,5,47,54,40,14,3,6,5,62,12,3,49,10,59,462,414,48
"N00003424",294,282,0,10,1,15,1,0,1,0,0,1,12,3,0,10,2,18,293,282,11
"N00003425",196,164,1,23,0,26,17,9,8,0,8,0,32,0,1,31,0,26,179,155,24
"N00003426",728,682,1,42,3,52,6,6,0,0,0,0,46,12,1,42,3,64,722,676,46
"N00003427",300,282,0,17,0,17,6,5,1,0,1,0,18,0,0,18,0,17,294,277,17
"N00003428",277,258,0,17,2,19,0,0,0,0,0,0,19,0,0,17,2,19,277,258,19
"N00003429",285,263,0,21,1,27,5,5,0,0,0,0,22,1,0,21,1,28,280,258,22
"N00003430",277,244,0,32,0,17,8,7,1,0,1,0,33,0,0,33,0,17,269,237,32
"N00003431",308,281,0,19,7,35,1,0,1,0,1,0,27,0,0,20,7,35,307,281,26
"N00003432",283,266,0,17,0,21,2,2,0,0,0,0,17,0,0,17,0,21,281,264,17
"N00003433",279,257,0,17,2,6,11,8,3,0,3,0,22,0,0,20,2,6,268,249,19
"N00003434",278,240,0,34,4,18,0,0,0,0,0,0,38,1,0,34,4,19,278,240,38
"N00003435",209,202,0,5,1,14,5,4,1,0,0,1,7,0,0,5,2,14,204,198,6
"N00003436",316,300,0,15,1,21,4,4,0,0,0,0,16,8,0,15,1,29,312,296,16
"N00003437",339,319,0,20,0,35,3,3,0,0,0,0,20,0,0,20,0,35,336,316,20
"N00003438",354,322,0,28,2,25,11,9,2,0,0,2,32,0,0,28,4,25,343,313,30
"N00003439",272,266,0,6,0,12,4,4,0,0,0,0,6,1,0,6,0,13,268,262,6
"N00003440",283,271,0,12,0,37,0,0,0,0,0,0,12,8,0,12,0,45,283,271,12
"N00003441",340,313,0,21,5,26,1,0,1,0,0,1,27,0,0,21,6,26,339,313,26
"N00003442",214,203,0,10,1,7,6,6,0,0,0,0,11,0,0,10,1,7,208,197,11
"N00003443",713,637,5,71,0,31,1,1,0,0,0,0,76,0,5,71,0,31,712,636,76
"N00003444",424,415,0,9,0,30,3,3,0,0,0,0,9,2,0,9,0,32,421,412,9
"N00003445",509,466,0,42,1,40,0,0,0,0,0,0,43,0,0,42,1,40,509,466,43
"N00003446",413,393,2,17,1,7,0,0,0,0,0,0,20,0,2,17,1,7,413,393,20
"N00003447",273,265,0,8,0,10,1,1,0,0,0,0,8,0,0,8,0,10,272,264,8
"N00003448",540,520,0,18,2,10,4,4,0,0,0,0,20,1,0,18,2,11,536,516,20
"N00003449",431,404,0,25,2,17,2,2,0,0,0,0,27,0,0,25,2,17,429,402,27
"N00003450",353,329,0,23,1,16,1,1,0,0,0,0,24,0,0,23,1,16,352,328,24
"N00003451",620,573,0,45,2,28,2,2,0,0,0,0,47,0,0,45,2,28,618,571,47
"N00003452",440,427,0,11,2,22,0,0,0,0,0,0,13,2,0,11,2,24,440,427,13
"N00003453",376,262,0,85,18,93,25,14,11,0,8,3,114,7,0,93,21,100,351,248,103
"N00003454",328,313,0,11,4,14,11,11,0,0,0,0,15,0,0,11,4,14,317,302,15
"N00003455",305,287,0,12,1,13,18,13,5,0,4,1,18,0,0,16,2,13,287,274,13
"N00003456",305,212,0,61,24,81,24,16,8,0,6,2,93,5,0,67,26,86,281,196,85
"N00003457",289,256,0,27,1,20,11,6,5,0,5,0,33,0,0,32,1,20,278,250,28
"N00003458",338,322,2,12,2,26,1,1,0,0,0,0,16,0,2,12,2,26,337,321,16
"N00003459",240,222,0,13,5,13,5,5,0,0,0,0,18,0,0,13,5,13,235,217,18
"N00003460",403,378,0,24,0,17,5,4,1,0,1,0,25,0,0,25,0,17,398,374,24
"N00003461",329,301,0,28,0,27,10,10,0,0,0,0,28,0,0,28,0,27,319,291,28
"N00003462",377,340,0,36,1,23,8,8,0,0,0,0,37,0,0,36,1,23,369,332,37
"N00003463",491,470,0,21,0,64,1,1,0,0,0,0,21,1,0,21,0,65,490,469,21
"N00003464",364,337,3,24,0,14,10,10,0,0,0,0,27,0,3,24,0,14,354,327,27
"N00003465",267,258,0,9,0,17,1,1,0,0,0,0,9,0,0,9,0,17,266,257,9
"N00003466",310,285,0,21,4,23,1,1,0,0,0,0,25,1,0,21,4,24,309,284,25
"N00003467",473,422,4,42,5,39,10,10,0,0,0,0,51,2,4,42,5,41,463,412,51
"N00003468",253,220,0,29,4,22,4,4,0,0,0,0,33,0,0,29,4,22,249,216,33
"N00003469",373,353,0,20,0,32,5,5,0,0,0,0,20,0,0,20,0,32,368,348,20
"N00003470",336,321,0,13,2,18,4,4,0,0,0,0,15,0,0,13,2,18,332,317,15
"N00003471",274,259,0,15,0,18,0,0,0,0,0,0,15,0,0,15,0,18,274,259,15
"N00003472",310,292,0,18,0,27,4,4,0,0,0,0,18,0,0,18,0,27,306,288,18
"N00003473",365,346,0,19,0,25,0,0,0,0,0,0,19,1,0,19,0,26,365,346,19
"N00003474",449,436,0,11,2,28,16,16,0,0,0,0,13,0,0,11,2,28,433,420,13
"N00003475",1177,1055,1,110,11,85,10,10,0,0,0,0,122,3,1,110,11,88,1167,1045,122
"N00003476",734,686,0,48,0,46,8,8,0,0,0,0,48,1,0,48,0,47,726,678,48
"N00003477",462,402,0,56,2,48,10,8,2,0,2,0,60,2,0,58,2,50,452,394,58
"N00003478",817,773,0,41,2,33,18,17,1,0,1,0,44,0,0,42,2,33,799,756,43
"N00003479",814,723,7,73,9,76,8,6,2,0,2,0,91,0,7,75,9,76,806,717,89
"N00003480",258,239,0,19,0,71,5,5,0,0,0,0,19,1,0,19,0,72,253,234,19
"N00003481",175,165,0,7,1,13,20,18,2,0,2,0,10,3,0,9,1,16,155,147,8
"N00003482",253,223,0,22,0,32,13,5,8,0,3,5,30,0,0,25,5,32,240,218,22
"N00003483",341,312,0,24,5,27,1,1,0,0,0,0,29,1,0,24,5,28,340,311,29
"N00003484",313,284,0,27,0,15,7,5,2,0,2,0,29,2,0,29,0,17,306,279,27
"N00003485",265,258,0,7,0,23,5,5,0,0,0,0,7,0,0,7,0,23,260,253,7
"N00003486",355,327,2,21,0,32,19,14,5,0,5,0,28,2,2,26,0,34,336,313,23
"N00003487",327,288,2,37,0,36,1,1,0,0,0,0,39,0,2,37,0,36,326,287,39
"N00003488",284,247,0,37,0,40,10,10,0,0,0,0,37,0,0,37,0,40,274,237,37
"N00003489",704,654,1,49,0,52,6,6,0,0,0,0,50,0,1,49,0,52,698,648,50
"N00003490",265,259,0,5,1,21,5,5,0,0,0,0,6,0,0,5,1,21,260,254,6
"N00003491",636,595,5,35,0,50,7,6,1,0,0,1,41,1,5,35,1,51,629,589,40
"N00003492",370,360,1,8,1,25,1,1,0,0,0,0,10,0,1,8,1,25,369,359,10
"N00003493",715,687,1,27,0,29,7,7,0,0,0,0,28,0,1,27,0,29,708,680,28
"N00003494",763,740,1,21,1,25,5,5,0,0,0,0,23,0,1,21,1,25,758,735,23
"N00003495",395,385,0,9,1,32,0,0,0,0,0,0,10,1,0,9,1,33,395,385,10
"N00003496",637,599,0,37,0,41,13,12,1,0,1,0,38,1,0,38,0,42,624,587,37
"N00003497",393,354,0,39,0,34,2,2,0,0,0,0,39,0,0,39,0,34,391,352,39
"N00003498",234,217,0,15,2,8,7,7,0,0,0,0,17,1,0,15,2,9,227,210,17
"N00003499",231,220,0,10,0,18,9,8,1,0,1,0,11,0,0,11,0,18,222,212,10
"N00003500",295,275,0,17,1,20,21,19,2,0,2,0,20,3,0,19,1,23,274,256,18
"N00003501",276,256,0,18,1,30,4,3,1,0,1,0,20,2,0,19,1,32,272,253,19
"N00003502",202,191,0,8,3,1,3,3,0,0,0,0,11,0,0,8,3,1,199,188,11
"N00003503",349,286,0,42,8,52,41,28,13,0,7,6,63,5,0,49,14,57,308,258,50
"N00003504",324,306,0,14,4,17,8,8,0,0,0,0,18,6,0,14,4,23,316,298,18
"N00003505",198,181,0,17,0,16,1,1,0,0,0,0,17,1,0,17,0,17,197,180,17
"N00003506",396,344,2,42,2,50,13,7,6,0,3,3,52,0,2,45,5,50,383,337,46
"N00003507",248,226,0,17,2,15,7,4,3,0,3,0,22,0,0,20,2,15,241,222,19
"N00003508",293,269,0,22,0,16,15,13,2,0,2,0,24,0,0,24,0,16,278,256,22
"N00003509",303,287,1,10,2,29,16,13,3,0,3,0,16,1,1,13,2,30,287,274,13
"N00003510",312,302,0,6,4,9,11,11,0,0,0,0,10,1,0,6,4,10,301,291,10
"N00003511",259,228,0,21,5,14,7,2,5,0,1,4,31,4,0,22,9,18,252,226,26
"N00003512",304,282,1,16,2,38,15,12,3,0,0,3,22,0,1,16,5,38,289,270,19
"N00003513",479,449,1,29,0,39,16,16,0,0,0,0,30,0,1,29,0,39,463,433,30
"N00003514",666,635,0,29,2,38,14,14,0,0,0,0,31,0,0,29,2,38,652,621,31
"N00003515",261,251,0,10,0,29,0,0,0,0,0,0,10,0,0,10,0,29,261,251,10
"N00003516",334,320,0,14,0,17,1,1,0,0,0,0,14,1,0,14,0,18,333,319,14
"N00003517",615,585,0,27,1,44,4,2,2,0,2,0,30,1,0,29,1,45,611,583,28
"N00003518",280,262,0,18,0,20,0,0,0,0,0,0,18,0,0,18,0,20,280,262,18
"N00003519",206,197,2,5,2,5,6,6,0,0,0,0,9,0,2,5,2,5,200,191,9
"N00003520",285,270,0,15,0,23,2,2,0,0,0,0,15,0,0,15,0,23,283,268,15
"N00003521",687,520,1,138,15,88,25,12,13,0,12,1,167,6,1,150,16,94,662,508,154
"N00003522",408,373,2,27,5,28,8,7,1,0,1,0,35,0,2,28,5,28,400,366,34
"N00003523",444,408,0,34,2,34,1,1,0,0,0,0,36,0,0,34,2,34,443,407,36
"N00003524",1204,1072,0,105,25,172,42,40,2,0,2,0,132,1,0,107,25,173,1162,1032,130
"N00003525",350,334,0,16,0,18,2,2,0,0,0,0,16,0,0,16,0,18,348,332,16
"N00003526",285,225,0,33,25,23,9,7,2,0,2,0,60,9,0,35,25,32,276,218,58
"N00003527",527,488,0,36,3,22,4,4,0,0,0,0,39,0,0,36,3,22,523,484,39
"N00003528",898,828,3,63,4,46,1,1,0,0,0,0,70,0,3,63,4,46,897,827,70
"N00003529",442,421,0,20,0,27,4,3,1,0,1,0,21,0,0,21,0,27,438,418,20
"N00003530",460,448,1,10,0,15,12,11,1,0,1,0,12,0,1,11,0,15,448,437,11
"N00003531",421,402,0,19,0,16,1,1,0,0,0,0,19,0,0,19,0,16,420,401,19
"N00003532",461,453,0,6,2,12,5,5,0,0,0,0,8,0,0,6,2,12,456,448,8
"N00003533",618,569,2,44,3,33,6,6,0,0,0,0,49,0,2,44,3,33,612,563,49
"N00003534",304,289,3,12,0,34,2,2,0,0,0,0,15,0,3,12,0,34,302,287,15
"N00003535",459,440,0,17,2,19,2,2,0,0,0,0,19,0,0,17,2,19,457,438,19
"N00003536",504,485,1,16,2,17,0,0,0,0,0,0,19,0,1,16,2,17,504,485,19
"N00003537",339,303,2,33,1,11,1,1,0,0,0,0,36,0,2,33,1,11,338,302,36
"N00003538",448,419,0,28,1,21,1,1,0,0,0,0,29,2,0,28,1,23,447,418,29
"N00003539",348,319,2,27,0,34,3,3,0,0,0,0,29,5,2,27,0,39,345,316,29
"N00003540",252,236,0,16,0,27,0,0,0,0,0,0,16,3,0,16,0,30,252,236,16
"N00003541",278,249,2,24,1,20,5,3,2,0,2,0,29,1,2,26,1,21,273,246,27
"N00003542",260,236,0,23,1,15,0,0,0,0,0,0,24,0,0,23,1,15,260,236,24
"N00003543",574,492,4,72,6,33,17,17,0,0,0,0,82,0,4,72,6,33,557,475,82
"N00003544",388,362,0,24,2,17,2,2,0,0,0,0,26,3,0,24,2,20,386,360,26
"N00003545",467,451,0,16,0,14,5,5,0,0,0,0,16,0,0,16,0,14,462,446,16
"N00003546",314,295,1,17,1,11,3,3,0,0,0,0,19,1,1,17,1,12,311,292,19
"N00003547",665,605,1,57,1,17,9,8,1,0,1,0,60,0,1,58,1,17,656,597,59
"N00003548",1769,1665,20,77,6,74,20,19,1,0,1,0,104,4,20,78,6,78,1749,1646,103
"N00003549",550,526,1,20,3,18,1,1,0,0,0,0,24,0,1,20,3,18,549,525,24
"N00003550",520,486,1,29,4,35,16,16,0,0,0,0,34,1,1,29,4,36,504,470,34
"N00003551",465,403,4,47,9,31,20,18,2,0,1,1,62,10,4,48,10,41,445,385,60
"N00003552",418,393,1,21,2,20,14,13,1,0,1,0,25,3,1,22,2,23,404,380,24
"N00003553",396,367,0,28,1,38,8,8,0,0,0,0,29,1,0,28,1,39,388,359,29
"N00003554",243,224,1,18,0,15,0,0,0,0,0,0,19,0,1,18,0,15,243,224,19
"N00003555",351,313,3,32,2,50,4,3,1,0,1,0,38,0,3,33,2,50,347,310,37
"N00003556",686,628,0,44,14,54,3,3,0,0,0,0,58,1,0,44,14,55,683,625,58
"N00003557",249,233,2,14,0,20,2,2,0,0,0,0,16,0,2,14,0,20,247,231,16
"N00003558",496,476,3,14,3,9,1,1,0,0,0,0,20,1,3,14,3,10,495,475,20
"N00003559",565,529,1,25,8,44,8,6,2,0,2,0,36,0,1,27,8,44,557,523,34
"N00003560",533,509,2,20,2,17,2,2,0,0,0,0,24,0,2,20,2,17,531,507,24
"N00003561",459,444,0,13,2,12,1,1,0,0,0,0,15,0,0,13,2,12,458,443,15
"N00003562",421,402,0,18,1,32,3,3,0,0,0,0,19,0,0,18,1,32,418,399,19
"N00003563",467,442,2,21,1,23,5,4,1,0,0,1,25,0,2,21,2,23,462,438,24
"N00003564",401,375,0,23,3,18,2,2,0,0,0,0,26,0,0,23,3,18,399,373,26
"N00003565",435,415,2,17,1,39,0,0,0,0,0,0,20,3,2,17,1,42,435,415,20
"N00003566",541,528,0,13,0,31,0,0,0,0,0,0,13,0,0,13,0,31,541,528,13
"N00003567",491,457,5,28,1,35,1,1,0,0,0,0,34,0,5,28,1,35,490,456,34
"N00003568",412,399,0,12,1,17,1,1,0,0,0,0,13,0,0,12,1,17,411,398,13
"N00003569",488,479,1,8,0,14,0,0,0,0,0,0,9,0,1,8,0,14,488,479,9
"N00003570",526,498,0,28,0,39,7,7,0,0,0,0,28,0,0,28,0,39,519,491,28
"N00003571",308,279,7,20,2,7,1,1,0,0,0,0,29,0,7,20,2,7,307,278,29
"N00003572",491,477,0,14,0,16,2,2,0,0,0,0,14,1,0,14,0,17,489,475,14
"N00003573",450,420,2,26,1,16,1,0,1,0,0,1,30,0,2,26,2,16,449,420,29
"N00003574",461,440,0,18,0,31,10,7,3,0,2,1,21,1,0,20,1,32,451,433,18
"N00003575",511,489,5,12,2,29,3,0,3,0,3,0,22,0,5,15,2,29,508,489,19
"N00003576",518,507,2,5,1,16,10,7,3,0,3,0,11,0,2,8,1,16,508,500,8
"N00003577",409,395,3,11,0,19,0,0,0,0,0,0,14,0,3,11,0,19,409,395,14
"N00003578",551,540,3,8,0,19,2,2,0,0,0,0,11,0,3,8,0,19,549,538,11
"N00003579",503,489,2,10,2,23,4,4,0,0,0,0,14,0,2,10,2,23,499,485,14
"N00003580",425,414,0,11,0,7,0,0,0,0,0,0,11,0,0,11,0,7,425,414,11
"N00003581",698,597,19,71,11,65,5,5,0,0,0,0,101,2,19,71,11,67,693,592,101
"N00003582",557,518,0,36,1,37,8,6,2,0,2,0,39,1,0,38,1,38,549,512,37
"N00003583",666,625,7,32,2,41,0,0,0,0,0,0,41,2,7,32,2,43,666,625,41
"N00003584",298,289,0,7,2,15,1,1,0,0,0,0,9,0,0,7,2,15,297,288,9
"N00003585",333,295,2,32,4,43,0,0,0,0,0,0,38,0,2,32,4,43,333,295,38
"N00003586",300,269,0,31,0,28,1,1,0,0,0,0,31,0,0,31,0,28,299,268,31
"N00003587",507,459,0,48,0,12,0,0,0,0,0,0,48,0,0,48,0,12,507,459,48
"N00003588",622,603,1,15,3,18,2,2,0,0,0,0,19,0,1,15,3,18,620,601,19
"N00003589",570,546,0,22,2,53,0,0,0,0,0,0,24,0,0,22,2,53,570,546,24
"N00003590",658,646,0,10,1,28,1,0,1,0,1,0,12,0,0,11,1,28,657,646,11
"N00003591",565,544,0,18,2,11,3,2,1,0,1,0,21,0,0,19,2,11,562,542,20
"N00003592",369,345,3,16,4,19,2,1,1,0,1,0,24,3,3,17,4,22,367,344,23
"N00003593",587,574,0,6,7,15,2,2,0,0,0,0,13,0,0,6,7,15,585,572,13
"N00003594",914,862,5,42,3,37,8,6,2,0,1,1,52,0,5,43,4,37,906,856,50
"N00003595",363,335,1,17,10,17,7,7,0,0,0,0,28,0,1,17,10,17,356,328,28
"N00003596",301,287,0,13,0,11,1,0,1,0,1,0,14,0,0,14,0,11,300,287,13
"N00003597",476,464,0,12,0,23,2,2,0,0,0,0,12,3,0,12,0,26,474,462,12
"N00003598",382,364,0,13,5,16,2,2,0,0,0,0,18,0,0,13,5,16,380,362,18
"N00003599",403,376,0,23,4,31,2,2,0,0,0,0,27,0,0,23,4,31,401,374,27
"N00003600",367,360,0,7,0,11,8,8,0,0,0,0,7,0,0,7,0,11,359,352,7
"N00003601",368,337,0,29,2,44,0,0,0,0,0,0,31,3,0,29,2,47,368,337,31
"N00003602",392,346,0,39,4,48,9,6,3,0,0,3,46,2,0,39,7,50,383,340,43
"N00003603",356,326,0,30,0,11,4,4,0,0,0,0,30,0,0,30,0,11,352,322,30
"N00003604",330,297,1,26,6,10,2,2,0,0,0,0,33,3,1,26,6,13,328,295,33
"N00003605",320,299,0,15,6,15,4,4,0,0,0,0,21,0,0,15,6,15,316,295,21
"N00003606",353,328,0,11,13,18,9,8,1,0,1,0,25,0,0,12,13,18,344,320,24
"N00003607",502,461,1,32,8,20,8,8,0,0,0,0,41,0,1,32,8,20,494,453,41
"N00003608",475,436,0,29,7,47,8,5,3,0,3,0,39,0,0,32,7,47,467,431,36
"N00003609",324,303,0,17,4,25,3,3,0,0,0,0,21,1,0,17,4,26,321,300,21
"N00003610",294,270,1,17,6,20,3,3,0,0,0,0,24,1,1,17,6,21,291,267,24
"N00003611",263,243,1,15,3,27,2,1,1,0,1,0,20,0,1,16,3,27,261,242,19
"N00003612",472,453,0,19,0,19,4,4,0,0,0,0,19,0,0,19,0,19,468,449,19
"N00003613",450,426,3,21,0,17,0,0,0,0,0,0,24,0,3,21,0,17,450,426,24
"N00003614",507,496,0,11,0,16,0,0,0,0,0,0,11,3,0,11,0,19,507,496,11
"N00003615",361,349,0,11,1,24,3,3,0,0,0,0,12,0,0,11,1,24,358,346,12
"N00003616",367,349,0,18,0,18,3,3,0,0,0,0,18,0,0,18,0,18,364,346,18
"N00003617",341,327,1,13,0,11,1,1,0,0,0,0,14,0,1,13,0,11,340,326,14
"N00003618",448,430,0,10,6,20,6,4,2,0,2,0,18,1,0,12,6,21,442,426,16
"N00003619",420,401,0,18,1,27,0,0,0,0,0,0,19,0,0,18,1,27,420,401,19
"N00003620",494,477,0,17,0,20,0,0,0,0,0,0,17,0,0,17,0,20,494,477,17
"N00003621",427,416,0,10,1,25,1,1,0,0,0,0,11,0,0,10,1,25,426,415,11
"N00003622",601,568,0,27,5,16,3,2,1,0,1,0,33,0,0,28,5,16,598,566,32
"N00003623",301,290,0,7,4,17,0,0,0,0,0,0,11,0,0,7,4,17,301,290,11
"N00003624",666,628,0,38,0,52,8,8,0,0,0,0,38,0,0,38,0,52,658,620,38
"N00003625",431,411,3,16,0,19,6,5,1,0,1,0,20,0,3,17,0,19,425,406,19
"N00003626",390,359,4,26,1,15,0,0,0,0,0,0,31,0,4,26,1,15,390,359,31
"N00003627",340,315,0,24,1,30,0,0,0,0,0,0,25,0,0,24,1,30,340,315,25
"N00003628",313,274,3,33,2,19,6,5,1,0,1,0,39,0,3,34,2,19,307,269,38
"N00003629",284,259,0,25,0,13,2,2,0,0,0,0,25,2,0,25,0,15,282,257,25
"N00003630",595,512,19,53,11,49,7,7,0,0,0,0,83,1,19,53,11,50,588,505,83
"N00003631",205,195,0,10,0,14,1,1,0,0,0,0,10,0,0,10,0,14,204,194,10
"N00003632",274,240,0,33,1,16,3,3,0,0,0,0,34,0,0,33,1,16,271,237,34
"N00003633",259,244,3,12,0,13,0,0,0,0,0,0,15,0,3,12,0,13,259,244,15
"N00003634",315,298,4,13,0,19,0,0,0,0,0,0,17,0,4,13,0,19,315,298,17
"N00003635",337,325,3,9,0,12,3,3,0,0,0,0,12,0,3,9,0,12,334,322,12
"N00003636",341,321,3,16,0,32,1,0,1,0,1,0,20,0,3,17,0,32,340,321,19
"N00003637",380,355,0,22,2,33,7,6,1,0,0,1,25,0,0,22,3,33,373,349,24
"N00003638",441,411,0,24,6,13,8,8,0,0,0,0,30,0,0,24,6,13,433,403,30
"N00003639",312,293,0,12,7,14,0,0,0,0,0,0,19,0,0,12,7,14,312,293,19
"N00003640",319,292,0,25,1,41,2,1,1,0,1,0,27,1,0,26,1,42,317,291,26
"N00003641",472,450,1,19,2,37,0,0,0,0,0,0,22,0,1,19,2,37,472,450,22
"N00003642",341,316,0,18,5,19,3,1,2,0,0,2,25,0,0,18,7,19,338,315,23
"N00003643",416,398,1,11,6,19,3,3,0,0,0,0,18,0,1,11,6,19,413,395,18
"N00003644",301,286,1,13,1,8,0,0,0,0,0,0,15,0,1,13,1,8,301,286,15
"N00003645",488,461,0,22,5,46,2,2,0,0,0,0,27,0,0,22,5,46,486,459,27
"N00003646",548,524,1,20,3,42,4,4,0,0,0,0,24,0,1,20,3,42,544,520,24
"N00003647",678,608,23,42,3,42,14,12,2,0,2,0,70,0,23,44,3,42,664,596,68
"N00003648",464,448,0,16,0,27,0,0,0,0,0,0,16,0,0,16,0,27,464,448,16
"N00003649",448,428,0,15,5,14,0,0,0,0,0,0,20,0,0,15,5,14,448,428,20
"N00003650",414,392,1,19,2,9,2,2,0,0,0,0,22,0,1,19,2,9,412,390,22
"N00003651",354,317,1,29,7,20,1,1,0,0,0,0,37,0,1,29,7,20,353,316,37
"N00003652",642,623,2,15,0,37,9,7,2,0,2,0,19,1,2,17,0,38,633,616,17
"N00003653",351,341,0,10,0,12,5,5,0,0,0,0,10,0,0,10,0,12,346,336,10
"N00003654",250,241,0,9,0,26,5,5,0,0,0,0,9,0,0,9,0,26,245,236,9
"N00003655",208,198,1,9,0,17,0,0,0,0,0,0,10,0,1,9,0,17,208,198,10
"N00003656",514,484,4,25,1,19,0,0,0,0,0,0,30,0,4,25,1,19,514,484,30
"N00003657",382,342,1,35,4,31,6,6,0,0,0,0,40,5,1,35,4,36,376,336,40
"N00003658",527,490,1,33,3,21,1,1,0,0,0,0,37,0,1,33,3,21,526,489,37
"N00003659",370,350,4,11,2,36,4,1,3,0,2,1,20,0,4,13,3,36,366,349,17
"N00003660",374,349,0,23,2,24,1,1,0,0,0,0,25,1,0,23,2,25,373,348,25
"N00003661",359,336,1,22,0,19,2,2,0,0,0,0,23,0,1,22,0,19,357,334,23
"N00003662",210,186,4,20,0,8,0,0,0,0,0,0,24,0,4,20,0,8,210,186,24
"N00003663",267,252,0,15,0,28,2,2,0,0,0,0,15,0,0,15,0,28,265,250,15
"N00003664",522,480,1,37,3,45,5,4,1,0,0,1,42,0,1,37,4,45,517,476,41
"N00003665",481,445,0,34,1,17,4,3,1,0,1,0,36,1,0,35,1,18,477,442,35
"N00003666",467,405,5,55,1,48,8,7,1,0,1,0,62,0,5,56,1,48,459,398,61
"N00003667",395,369,0,25,1,24,1,1,0,0,0,0,26,0,0,25,1,24,394,368,26
"N00003668",425,386,0,35,4,27,3,3,0,0,0,0,39,0,0,35,4,27,422,383,39
"N00003669",451,421,0,21,7,12,2,0,2,0,0,2,30,5,0,21,9,17,449,421,28
"N00003670",385,359,2,22,2,21,3,3,0,0,0,0,26,0,2,22,2,21,382,356,26
"N00003671",296,280,4,11,1,27,1,1,0,0,0,0,16,1,4,11,1,28,295,279,16
"N00003672",289,279,0,10,0,32,0,0,0,0,0,0,10,0,0,10,0,32,289,279,10
"N00003673",249,240,0,7,2,9,0,0,0,0,0,0,9,0,0,7,2,9,249,240,9
"N00003674",413,393,0,19,1,28,5,5,0,0,0,0,20,0,0,19,1,28,408,388,20
"N00003675",308,278,3,27,0,7,1,1,0,0,0,0,30,1,3,27,0,8,307,277,30
"N00003676",303,267,0,29,2,26,12,7,5,0,5,0,36,0,0,34,2,26,291,260,31
"N00003677",295,275,0,16,2,22,3,1,2,0,2,0,20,0,0,18,2,22,292,274,18
"N00003678",378,359,0,18,1,45,2,2,0,0,0,0,19,3,0,18,1,48,376,357,19
"N00003679",327,305,0,13,6,28,7,4,3,0,3,0,22,3,0,16,6,31,320,301,19
"N00003680",254,225,0,24,3,8,8,6,2,0,1,1,29,11,0,25,4,19,246,219,27
"N00003681",409,351,2,37,8,39,35,24,11,3,7,1,58,7,5,44,9,46,374,327,47
"N00003682",226,199,2,24,1,8,2,2,0,0,0,0,27,0,2,24,1,8,224,197,27
"N00003683",403,365,0,37,1,44,10,10,0,0,0,0,38,0,0,37,1,44,393,355,38
"N00003684",329,314,0,9,5,16,4,3,1,0,1,0,15,0,0,10,5,16,325,311,14
"N00003685",371,349,0,21,1,34,4,4,0,0,0,0,22,0,0,21,1,34,367,345,22
"N00003686",364,336,1,27,0,14,1,1,0,0,0,0,28,5,1,27,0,19,363,335,28
"N00003687",454,431,0,18,2,20,6,3,3,0,3,0,23,0,0,21,2,20,448,428,20
"N00003688",365,310,2,51,2,39,2,2,0,0,0,0,55,0,2,51,2,39,363,308,55
"N00003689",293,233,10,50,0,33,2,2,0,0,0,0,60,0,10,50,0,33,291,231,60
"N00003690",543,502,3,34,0,37,5,1,4,0,4,0,41,0,3,38,0,37,538,501,37
"N00003691",467,441,0,21,0,29,7,2,5,0,5,0,26,0,0,26,0,29,460,439,21
"N00003692",379,365,0,12,2,20,0,0,0,0,0,0,14,0,0,12,2,20,379,365,14
"N00003693",423,387,8,27,0,32,2,1,1,0,1,0,36,0,8,28,0,32,421,386,35
"N00003694",516,488,4,21,3,17,3,3,0,0,0,0,28,0,4,21,3,17,513,485,28
"N00003695",379,360,2,14,3,23,3,3,0,0,0,0,19,2,2,14,3,25,376,357,19
"N00003696",431,408,0,22,1,13,0,0,0,0,0,0,23,0,0,22,1,13,431,408,23
"N00003697",454,425,0,24,2,31,10,7,3,0,3,0,29,0,0,27,2,31,444,418,26
"N00003698",704,673,0,25,6,19,1,1,0,0,0,0,31,3,0,25,6,22,703,672,31
"N00003699",406,389,0,17,0,19,3,3,0,0,0,0,17,0,0,17,0,19,403,386,17
"N00003700",400,366,0,29,5,45,0,0,0,0,0,0,34,0,0,29,5,45,400,366,34
"N00003701",624,588,0,34,2,18,3,3,0,0,0,0,36,0,0,34,2,18,621,585,36
"N00003702",862,825,0,25,12,41,13,13,0,0,0,0,37,0,0,25,12,41,849,812,37
"N00003703",629,588,2,37,2,41,1,1,0,0,0,0,41,0,2,37,2,41,628,587,41
"N00003704",427,392,0,34,1,21,1,1,0,0,0,0,35,0,0,34,1,21,426,391,35
"N00003705",429,390,4,34,1,28,6,6,0,0,0,0,39,0,4,34,1,28,423,384,39
"N00003706",575,524,7,41,2,61,2,1,1,0,1,0,51,0,7,42,2,61,573,523,50
"N00003707",562,548,0,13,1,30,3,3,0,0,0,0,14,0,0,13,1,30,559,545,14
"N00003708",510,478,5,22,2,25,4,1,3,0,3,0,32,0,5,25,2,25,506,477,29
"N00003709",386,359,0,27,0,29,0,0,0,0,0,0,27,0,0,27,0,29,386,359,27
"N00003710",475,441,3,26,4,40,1,0,1,0,1,0,34,0,3,27,4,40,474,441,33
"N00003711",545,515,10,17,2,28,1,0,1,0,1,0,30,0,10,18,2,28,544,515,29
"N00003712",384,348,0,27,6,24,3,0,3,0,3,0,36,0,0,30,6,24,381,348,33
"N00003713",381,344,0,29,6,42,6,4,2,0,2,0,37,0,0,31,6,42,375,340,35
"N00003714",401,371,2,27,1,32,7,7,0,0,0,0,30,2,2,27,1,34,394,364,30
"N00003715",291,275,0,12,4,13,1,1,0,0,0,0,16,0,0,12,4,13,290,274,16
"N00003716",324,292,0,26,3,42,5,2,3,0,3,0,32,0,0,29,3,42,319,290,29
"N00003717",271,211,4,44,12,37,1,1,0,0,0,0,60,0,4,44,12,37,270,210,60
"N00003718",1470,1399,2,61,8,85,13,13,0,0,0,0,71,0,2,61,8,85,1457,1386,71
"N00003719",460,420,2,32,5,34,6,5,1,0,0,1,40,0,2,32,6,34,454,415,39
"N00003720",411,392,0,14,5,39,3,3,0,0,0,0,19,0,0,14,5,39,408,389,19
"N00003721",579,541,1,29,8,18,1,1,0,0,0,0,38,2,1,29,8,20,578,540,38
"N00003722",488,471,2,14,1,23,0,0,0,0,0,0,17,0,2,14,1,23,488,471,17
"N00003723",421,402,0,17,2,13,2,2,0,0,0,0,19,0,0,17,2,13,419,400,19
"N00003724",419,400,1,12,4,17,6,4,2,0,0,2,19,0,1,12,6,17,413,396,17
"N00003725",303,280,2,20,1,14,1,1,0,0,0,0,23,2,2,20,1,16,302,279,23
"N00003726",472,464,0,6,2,33,4,4,0,0,0,0,8,0,0,6,2,33,468,460,8
"N00003727",406,368,6,29,3,14,8,8,0,0,0,0,38,0,6,29,3,14,398,360,38
"N00003728",357,346,0,8,2,14,2,1,1,0,1,0,11,0,0,9,2,14,355,345,10
"N00003729",404,377,0,21,6,10,1,1,0,0,0,0,27,0,0,21,6,10,403,376,27
"N00003730",464,445,1,8,10,24,0,0,0,0,0,0,19,0,1,8,10,24,464,445,19
"N00003731",374,358,0,12,3,25,1,0,1,0,1,0,16,0,0,13,3,25,373,358,15
"N00003732",709,641,11,50,7,32,6,6,0,0,0,0,68,0,11,50,7,32,703,635,68
"N00003733",357,344,0,13,0,24,1,1,0,0,0,0,13,0,0,13,0,24,356,343,13
"N00003734",380,356,0,22,2,22,4,4,0,0,0,0,24,0,0,22,2,22,376,352,24
"N00003735",306,284,0,22,0,24,6,6,0,0,0,0,22,1,0,22,0,25,300,278,22
"N00003736",350,332,1,11,3,26,14,11,3,0,3,0,18,0,1,14,3,26,336,321,15
"N00003737",544,504,3,29,5,39,10,7,3,1,2,0,40,0,4,31,5,39,534,497,37
"N00003738",292,256,4,27,5,18,2,2,0,0,0,0,36,0,4,27,5,18,290,254,36
"N00003739",440,398,0,30,9,38,25,22,3,0,3,0,42,1,0,33,9,39,415,376,39
"N00003740",283,271,0,7,4,17,4,3,1,0,1,0,12,0,0,8,4,17,279,268,11
"N00003741",244,186,3,34,14,55,8,1,7,1,4,2,58,6,4,38,16,61,236,185,51
"N00003742",316,280,0,32,2,15,6,4,2,0,1,1,36,0,0,33,3,15,310,276,34
"N00003743",539,500,1,37,1,29,2,2,0,0,0,0,39,0,1,37,1,29,537,498,39
"N00003744",393,372,1,14,6,21,0,0,0,0,0,0,21,0,1,14,6,21,393,372,21
"N00003745",462,445,0,14,2,32,2,1,1,0,1,0,17,2,0,15,2,34,460,444,16
"N00003746",338,310,0,26,2,42,0,0,0,0,0,0,28,1,0,26,2,43,338,310,28
"N00003747",314,285,5,19,4,37,6,5,1,0,0,1,29,0,5,19,5,37,308,280,28
"N00003748",392,371,0,19,2,19,1,1,0,0,0,0,21,0,0,19,2,19,391,370,21
"N00003749",514,475,2,26,6,62,9,4,5,0,2,3,39,2,2,28,9,64,505,471,34
"N00003750",491,478,0,9,2,19,12,10,2,0,2,0,13,0,0,11,2,19,479,468,11
"N00003751",559,514,1,31,11,32,10,8,2,0,2,0,45,2,1,33,11,34,549,506,43
"N00003752",456,421,0,33,2,37,9,9,0,0,0,0,35,0,0,33,2,37,447,412,35
"N00003753",495,471,0,20,3,24,1,0,1,0,1,0,24,0,0,21,3,24,494,471,23
"N00003754",347,329,0,10,4,30,6,2,4,0,3,1,18,5,0,13,5,35,341,327,14
"N00003755",457,399,2,51,4,24,12,11,1,0,1,0,58,0,2,52,4,24,445,388,57
"N00003756",353,339,5,9,0,13,6,6,0,0,0,0,14,0,5,9,0,13,347,333,14
"N00003757",356,328,2,22,4,17,1,1,0,0,0,0,28,0,2,22,4,17,355,327,28
"N00003758",547,520,1,26,0,52,8,8,0,0,0,0,27,1,1,26,0,53,539,512,27
"N00003759",321,280,2,38,1,16,3,3,0,0,0,0,41,0,2,38,1,16,318,277,41
"N00003760",319,291,0,28,0,21,3,3,0,0,0,0,28,3,0,28,0,24,316,288,28
"N00003761",439,410,0,27,1,16,1,0,1,0,1,0,29,0,0,28,1,16,438,410,28
"N00003762",494,470,0,22,1,17,7,6,1,0,1,0,24,0,0,23,1,17,487,464,23
"N00003763",511,494,1,15,1,34,0,0,0,0,0,0,17,0,1,15,1,34,511,494,17
"N00003764",613,589,1,21,2,17,9,9,0,0,0,0,24,0,1,21,2,17,604,580,24
"N00003765",426,404,0,21,1,19,0,0,0,0,0,0,22,0,0,21,1,19,426,404,22
"N00003766",495,472,1,18,4,36,1,1,0,0,0,0,23,6,1,18,4,42,494,471,23
"N00003767",495,476,2,16,1,23,2,2,0,0,0,0,19,0,2,16,1,23,493,474,19
"N00003768",609,523,7,60,15,37,17,13,4,0,0,4,86,3,7,60,19,40,592,510,82
"N00003769",351,307,0,37,6,58,1,0,1,0,1,0,44,0,0,38,6,58,350,307,43
"N00003770",494,442,3,37,5,46,15,8,7,0,7,0,52,1,3,44,5,47,479,434,45
"N00003771",512,446,3,53,5,41,12,7,5,0,5,0,66,0,3,58,5,41,500,439,61
"N00003772",186,166,0,18,2,18,0,0,0,0,0,0,20,2,0,18,2,20,186,166,20
"N00003773",323,306,0,16,0,29,11,10,1,0,1,0,17,3,0,17,0,32,312,296,16
"N00003774",338,322,0,11,4,13,5,4,1,0,1,0,16,0,0,12,4,13,333,318,15
"N00003775",539,487,3,44,5,46,1,1,0,0,0,0,52,2,3,44,5,48,538,486,52
"N00003776",384,363,0,16,3,41,8,6,2,0,2,0,21,0,0,18,3,41,376,357,19
"N00003777",289,278,1,4,4,29,3,1,2,0,2,0,11,12,1,6,4,41,286,277,9
"N00003778",391,348,1,34,7,29,9,8,1,0,0,1,43,1,1,34,8,30,382,340,42
"N00003779",355,306,9,36,1,19,7,4,3,0,3,0,49,1,9,39,1,20,348,302,46
"N00003780",380,358,0,22,0,56,4,4,0,0,0,0,22,0,0,22,0,56,376,354,22
"N00003781",388,365,0,17,2,33,7,3,4,0,2,2,23,0,0,19,4,33,381,362,19
"N00003782",581,546,0,29,2,34,15,11,4,0,4,0,35,0,0,33,2,34,566,535,31
"N00003783",330,298,0,20,2,20,14,4,10,0,8,2,32,1,0,28,4,21,316,294,22
"N00003784",501,481,2,10,8,20,5,5,0,0,0,0,20,0,2,10,8,20,496,476,20
"N00003785",570,547,0,22,1,29,5,5,0,0,0,0,23,1,0,22,1,30,565,542,23
"N00003786",495,477,0,16,2,24,1,1,0,0,0,0,18,0,0,16,2,24,494,476,18
"N00003787",402,383,0,19,0,22,0,0,0,0,0,0,19,0,0,19,0,22,402,383,19
"N00003788",337,293,2,35,7,28,5,5,0,0,0,0,44,1,2,35,7,29,332,288,44
"N00003789",442,426,0,11,5,11,2,2,0,0,0,0,16,0,0,11,5,11,440,424,16
"N00003790",363,332,0,24,6,13,2,1,1,0,1,0,31,0,0,25,6,13,361,331,30
"N00003791",769,719,0,45,3,21,5,3,2,0,0,2,50,0,0,45,5,21,764,716,48
"N00003792",313,267,0,40,6,13,7,7,0,0,0,0,46,0,0,40,6,13,306,260,46
"N00003793",722,672,8,23,15,33,20,16,4,0,3,1,50,5,8,26,16,38,702,656,46
"N00003794",401,382,3,16,0,17,3,3,0,0,0,0,19,0,3,16,0,17,398,379,19
"N00003795",507,479,2,21,2,21,3,0,3,0,3,0,28,0,2,24,2,21,504,479,25
"N00003796",654,622,1,23,8,25,6,6,0,0,0,0,32,4,1,23,8,29,648,616,32
"N00003797",516,485,3,20,7,36,8,7,1,0,1,0,31,0,3,21,7,36,508,478,30
"N00003798",474,461,0,12,1,15,10,10,0,0,0,0,13,0,0,12,1,15,464,451,13
"N00003799",329,301,0,22,4,35,3,1,2,0,2,0,28,0,0,24,4,35,326,300,26
"N00003800",464,433,0,28,3,42,4,4,0,0,0,0,31,0,0,28,3,42,460,429,31
"N00003801",414,377,0,32,5,39,8,8,0,0,0,0,37,0,0,32,5,39,406,369,37
"N00003802",282,262,0,17,3,14,1,1,0,0,0,0,20,0,0,17,3,14,281,261,20
"N00003803",373,361,0,11,1,66,0,0,0,0,0,0,12,1,0,11,1,67,373,361,12
"N00003804",436,396,0,36,4,42,0,0,0,0,0,0,40,0,0,36,4,42,436,396,40
"N00003805",289,255,3,27,4,26,0,0,0,0,0,0,34,0,3,27,4,26,289,255,34
"N00003806",460,414,3,35,7,40,7,6,1,0,1,0,46,1,3,36,7,41,453,408,45
"N00003807",305,258,1,46,0,29,0,0,0,0,0,0,47,1,1,46,0,30,305,258,47
"N00003808",335,298,3,26,7,22,14,13,1,0,1,0,37,0,3,27,7,22,321,285,36
"N00003809",395,350,1,42,1,25,3,2,1,0,1,0,45,0,1,43,1,25,392,348,44
"N00003810",188,174,1,13,0,31,0,0,0,0,0,0,14,0,1,13,0,31,188,174,14
"N00003811",377,352,0,23,2,27,5,5,0,0,0,0,25,0,0,23,2,27,372,347,25
"N00003812",342,326,4,9,2,28,1,0,1,0,1,0,16,2,4,10,2,30,341,326,15
"N00003813",334,308,1,24,1,24,0,0,0,0,0,0,26,0,1,24,1,24,334,308,26
"N00003814",350,322,2,26,0,51,1,1,0,0,0,0,28,0,2,26,0,51,349,321,28
"N00003815",605,535,0,67,3,102,7,7,0,0,0,0,70,0,0,67,3,102,598,528,70
"N00003816",392,351,1,39,1,16,0,0,0,0,0,0,41,1,1,39,1,17,392,351,41
"N00003817",505,467,1,37,0,29,1,1,0,0,0,0,38,0,1,37,0,29,504,466,38
"N00003818",533,508,0,19,5,27,6,5,1,0,1,0,25,0,0,20,5,27,527,503,24
"N00003819",388,351,0,32,5,31,0,0,0,0,0,0,37,0,0,32,5,31,388,351,37
"N00003820",593,539,2,47,4,13,2,1,1,0,1,0,54,0,2,48,4,13,591,538,53
"N00003821",414,402,1,10,1,22,2,2,0,0,0,0,12,0,1,10,1,22,412,400,12
"N00003822",557,524,0,28,2,14,4,1,3,0,3,0,33,0,0,31,2,14,553,523,30
"N00003823",588,560,1,25,1,35,1,0,1,0,1,0,28,0,1,26,1,35,587,560,27
"N00003824",749,706,4,33,1,8,6,1,5,0,5,0,43,0,4,38,1,8,743,705,38
"N00003825",965,888,13,53,8,47,5,2,3,0,3,0,77,3,13,56,8,50,960,886,74
"N00003826",675,645,0,29,1,21,5,5,0,0,0,0,30,0,0,29,1,21,670,640,30
"N00003827",1060,1004,8,41,5,23,3,1,2,0,2,0,56,0,8,43,5,23,1057,1003,54
"N00003828",463,451,0,11,1,24,2,2,0,0,0,0,12,0,0,11,1,24,461,449,12
"N00003829",519,498,0,13,8,10,7,7,0,0,0,0,21,0,0,13,8,10,512,491,21
"N00003830",537,506,3,22,1,20,9,4,5,0,5,0,31,0,3,27,1,20,528,502,26
"N00003831",292,275,0,13,4,7,1,1,0,0,0,0,17,1,0,13,4,8,291,274,17
"N00003832",558,531,0,18,9,35,0,0,0,0,0,0,27,2,0,18,9,37,558,531,27
"N00003833",467,420,5,33,9,17,1,1,0,0,0,0,47,2,5,33,9,19,466,419,47
"N00003834",428,386,2,39,1,14,0,0,0,0,0,0,42,0,2,39,1,14,428,386,42
"N00003835",539,483,0,48,4,56,10,6,4,0,4,0,56,0,0,52,4,56,529,477,52
"N00003836",343,305,0,30,8,40,1,1,0,0,0,0,38,1,0,30,8,41,342,304,38
"N00003837",337,320,1,13,2,32,2,1,1,0,0,1,17,0,1,13,3,32,335,319,16
"N00003838",409,340,1,60,7,41,2,1,1,0,1,0,69,5,1,61,7,46,407,339,68
"N00003839",409,364,5,27,10,31,8,5,3,0,1,2,45,0,5,28,12,31,401,359,42
"N00003840",428,404,0,23,1,12,1,1,0,0,0,0,24,0,0,23,1,12,427,403,24
"N00003841",256,248,0,6,2,18,4,4,0,0,0,0,8,2,0,6,2,20,252,244,8
"N00003842",413,378,0,32,3,52,5,5,0,0,0,0,35,0,0,32,3,52,408,373,35
"N00003843",348,298,0,40,10,48,3,3,0,0,0,0,50,2,0,40,10,50,345,295,50
"N00003844",515,476,0,31,8,50,1,1,0,0,0,0,39,1,0,31,8,51,514,475,39
"N00003845",299,286,0,10,3,13,6,6,0,0,0,0,13,0,0,10,3,13,293,280,13
"N00003846",620,547,6,63,0,44,10,6,4,0,4,0,73,6,6,67,0,50,610,541,69
"N00003847",254,239,0,13,2,20,3,3,0,0,0,0,15,0,0,13,2,20,251,236,15
"N00003848",362,340,0,18,2,25,6,4,2,0,1,1,22,0,0,19,3,25,356,336,20
"N00003849",608,587,0,14,7,18,1,1,0,0,0,0,21,0,0,14,7,18,607,586,21
"N00003850",415,393,0,18,4,10,0,0,0,0,0,0,22,0,0,18,4,10,415,393,22
"N00003851",470,458,0,11,1,22,2,2,0,0,0,0,12,0,0,11,1,22,468,456,12
"N00003852",352,330,0,21,0,18,1,0,1,0,1,0,22,0,0,22,0,18,351,330,21
"N00003853",514,500,0,11,1,12,6,4,2,0,2,0,14,0,0,13,1,12,508,496,12
"N00003854",466,434,6,10,16,16,0,0,0,0,0,0,32,0,6,10,16,16,466,434,32
"N00003855",454,425,3,19,6,12,2,1,1,0,1,0,29,1,3,20,6,13,452,424,28
"N00003856",491,470,1,16,4,32,1,1,0,0,0,0,21,0,1,16,4,32,490,469,21
"N00003857",547,516,0,25,6,31,1,1,0,0,0,0,31,1,0,25,6,32,546,515,31
"N00003858",511,488,2,21,0,32,1,1,0,0,0,0,23,0,2,21,0,32,510,487,23
"N00003859",478,437,0,39,2,33,0,0,0,0,0,0,41,2,0,39,2,35,478,437,41
"N00003860",1070,994,8,60,8,60,1,1,0,0,0,0,76,1,8,60,8,61,1069,993,76
"N00003861",546,524,1,20,1,21,0,0,0,0,0,0,22,0,1,20,1,21,546,524,22
"N00003862",431,407,0,23,1,15,0,0,0,0,0,0,24,0,0,23,1,15,431,407,24
"N00003863",236,195,5,27,7,31,8,6,2,0,0,2,41,0,5,27,9,31,228,189,39
"N00003864",380,359,0,15,6,23,6,6,0,0,0,0,21,0,0,15,6,23,374,353,21
"N00003865",255,221,0,34,0,33,9,9,0,0,0,0,34,0,0,34,0,33,246,212,34
"N00003866",339,303,1,29,4,24,8,6,2,0,2,0,36,0,1,31,4,24,331,297,34
"N00003867",723,608,9,95,10,54,6,5,1,0,1,0,115,0,9,96,10,54,717,603,114
"N00003868",351,326,0,21,4,35,5,5,0,0,0,0,25,5,0,21,4,40,346,321,25
"N00003869",1226,1055,8,132,27,188,18,14,4,0,4,0,171,2,8,136,27,190,1208,1041,167
"N00003870",254,206,2,36,10,35,0,0,0,0,0,0,48,0,2,36,10,35,254,206,48
"N00003871",730,694,2,29,2,31,12,9,3,0,3,0,36,0,2,32,2,31,718,685,33
"N00003872",278,234,0,38,4,15,7,5,2,0,1,1,44,0,0,39,5,15,271,229,42
"N00003873",1042,959,6,68,7,147,10,8,2,0,2,0,83,2,6,70,7,149,1032,951,81
"N00003874",533,502,2,23,5,48,4,3,1,0,0,1,31,2,2,23,6,50,529,499,30
"N00003875",418,389,0,25,4,23,4,4,0,0,0,0,29,0,0,25,4,23,414,385,29
"N00003876",592,560,2,28,1,21,2,1,1,0,1,0,32,0,2,29,1,21,590,559,31
"N00003877",373,344,1,26,2,16,0,0,0,0,0,0,29,0,1,26,2,16,373,344,29
"N00003878",478,468,0,9,1,12,0,0,0,0,0,0,10,0,0,9,1,12,478,468,10
"N00003879",503,478,11,12,2,5,0,0,0,0,0,0,25,0,11,12,2,5,503,478,25
"N00003880",469,440,6,22,1,29,1,1,0,0,0,0,29,1,6,22,1,30,468,439,29
"N00003881",491,472,0,15,3,45,5,4,1,0,1,0,19,0,0,16,3,45,486,468,18
"N00003882",304,275,0,26,3,22,0,0,0,0,0,0,29,5,0,26,3,27,304,275,29
"N00003883",819,759,0,48,5,54,12,5,7,0,5,2,60,0,0,53,7,54,807,754,53
"N00003884",747,648,7,89,3,35,10,10,0,0,0,0,99,5,7,89,3,40,737,638,99
"N00003885",337,324,1,12,0,26,6,6,0,0,0,0,13,0,1,12,0,26,331,318,13
"N00003886",305,276,0,29,0,25,0,0,0,0,0,0,29,0,0,29,0,25,305,276,29
"N00003887",516,487,0,27,1,52,10,9,1,0,1,0,29,0,0,28,1,52,506,478,28
"N00003888",240,229,0,9,0,11,9,7,2,0,2,0,11,0,0,11,0,11,231,222,9
"N00003889",429,360,1,61,0,26,28,21,7,0,3,4,69,12,1,64,4,38,401,339,62
"N00003890",256,237,0,8,7,20,14,10,4,0,4,0,19,1,0,12,7,21,242,227,15
"N00003891",316,285,0,23,1,23,19,12,7,0,7,0,31,0,0,30,1,23,297,273,24
"N00003892",256,228,0,27,0,16,17,16,1,0,1,0,28,2,0,28,0,18,239,212,27
"N00003893",248,220,1,23,3,15,38,37,1,1,0,0,28,1,2,23,3,16,210,183,27
"N00003894",274,255,0,19,0,19,16,16,0,0,0,0,19,3,0,19,0,22,258,239,19
"N00003895",279,245,0,24,3,23,38,31,7,0,2,5,34,16,0,26,8,39,241,214,27
"N00003896",771,686,8,77,0,59,0,0,0,0,0,0,85,2,8,77,0,61,771,686,85
"N00003897",281,239,0,41,0,25,5,4,1,0,1,0,42,0,0,42,0,25,276,235,41
"N00003898",372,360,0,11,1,21,2,2,0,0,0,0,12,0,0,11,1,21,370,358,12
"N00003899",362,341,0,13,1,27,7,0,7,0,7,0,21,0,0,20,1,27,355,341,14
"N00003900",280,259,0,21,0,13,0,0,0,0,0,0,21,6,0,21,0,19,280,259,21
"N00003901",267,246,0,21,0,31,2,2,0,0,0,0,21,0,0,21,0,31,265,244,21
"N00003902",349,311,3,35,0,24,0,0,0,0,0,0,38,0,3,35,0,24,349,311,38
"N00003903",658,618,0,36,2,57,4,2,2,0,0,2,40,0,0,36,4,57,654,616,38
"N00003904",511,475,0,33,2,51,5,4,1,0,1,0,36,1,0,34,2,52,506,471,35
"N00003905",294,268,0,24,0,17,3,1,2,0,2,0,26,8,0,26,0,25,291,267,24
"N00003906",229,188,3,37,0,31,1,0,1,0,1,0,41,0,3,38,0,31,228,188,40
"N00003907",306,269,0,36,1,32,3,3,0,0,0,0,37,2,0,36,1,34,303,266,37
"N00003908",195,169,0,26,0,16,0,0,0,0,0,0,26,0,0,26,0,16,195,169,26
"N00003909",353,329,0,24,0,56,0,0,0,0,0,0,24,1,0,24,0,57,353,329,24
"N00003910",250,245,0,4,0,22,1,0,1,0,1,0,5,0,0,5,0,22,249,245,4
"N00003911",1281,1184,14,79,3,134,8,7,1,0,0,1,97,0,14,79,4,134,1273,1177,96
"N00003912",469,421,5,40,0,34,5,2,3,0,3,0,48,0,5,43,0,34,464,419,45
"N00003913",261,236,0,24,1,11,4,4,0,0,0,0,25,1,0,24,1,12,257,232,25
"N00003914",366,348,0,12,5,9,5,4,1,0,1,0,18,2,0,13,5,11,361,344,17
"N00003915",308,293,0,14,0,10,7,6,1,0,1,0,15,0,0,15,0,10,301,287,14
"N00003916",390,371,0,15,3,23,5,4,1,0,1,0,19,0,0,16,3,23,385,367,18
"N00003917",280,273,0,7,0,16,0,0,0,0,0,0,7,0,0,7,0,16,280,273,7
"N00003918",267,241,0,26,0,23,0,0,0,0,0,0,26,3,0,26,0,26,267,241,26
"N00003919",297,274,1,21,0,16,2,1,1,0,1,0,23,0,1,22,0,16,295,273,22
"N00003920",329,315,0,13,1,22,7,7,0,0,0,0,14,0,0,13,1,22,322,308,14
"N00003921",326,316,0,10,0,9,1,1,0,0,0,0,10,1,0,10,0,10,325,315,10
"N00003922",303,290,0,10,2,26,8,7,1,0,1,0,13,0,0,11,2,26,295,283,12
"N00003923",306,291,0,11,4,19,5,5,0,0,0,0,15,0,0,11,4,19,301,286,15
"N00003924",305,277,0,28,0,16,6,6,0,0,0,0,28,0,0,28,0,16,299,271,28
"N00003925",289,274,0,11,0,18,20,16,4,0,4,0,15,8,0,15,0,26,269,258,11
"N00003926",305,297,0,8,0,53,8,8,0,0,0,0,8,0,0,8,0,53,297,289,8
"N00003927",312,305,0,5,0,19,11,9,2,0,2,0,7,0,0,7,0,19,301,296,5
"N00003928",462,431,0,28,1,31,15,13,2,0,1,1,31,2,0,29,2,33,447,418,29
"N00003929",261,232,0,27,2,24,4,4,0,0,0,0,29,0,0,27,2,24,257,228,29
"N00003930",318,294,1,22,0,23,2,1,1,0,1,0,24,0,1,23,0,23,316,293,23
"N00003931",214,197,3,14,0,7,3,3,0,0,0,0,17,1,3,14,0,8,211,194,17
"N00003932",347,332,0,14,1,15,2,2,0,0,0,0,15,0,0,14,1,15,345,330,15
"N00003933",841,745,7,84,1,60,9,5,4,0,4,0,96,0,7,88,1,60,832,740,92
"N00003934",337,327,2,8,0,20,0,0,0,0,0,0,10,0,2,8,0,20,337,327,10
"N00003935",353,331,1,20,1,11,5,5,0,0,0,0,22,0,1,20,1,11,348,326,22
"N00003936",938,873,3,60,1,56,9,8,1,0,0,1,65,0,3,60,2,56,929,865,64
"N00003937",331,306,2,20,2,22,5,4,1,0,1,0,25,0,2,21,2,22,326,302,24
"N00003938",259,246,0,13,0,17,2,2,0,0,0,0,13,0,0,13,0,17,257,244,13
"N00003939",386,373,0,13,0,24,3,3,0,0,0,0,13,0,0,13,0,24,383,370,13
"N00003940",317,308,1,8,0,17,4,4,0,0,0,0,9,0,1,8,0,17,313,304,9
"N00003941",379,354,5,17,2,11,5,4,1,0,0,1,25,0,5,17,3,11,374,350,24
"N00003942",468,432,0,36,0,41,2,2,0,0,0,0,36,1,0,36,0,42,466,430,36
"N00003943",657,599,4,52,2,49,22,22,0,0,0,0,58,2,4,52,2,51,635,577,58
"N00003944",390,355,0,35,0,32,2,2,0,0,0,0,35,0,0,35,0,32,388,353,35
"N00003945",333,309,0,23,1,23,3,3,0,0,0,0,24,0,0,23,1,23,330,306,24
"N00003946",446,406,2,38,0,30,0,0,0,0,0,0,40,1,2,38,0,31,446,406,40
"N00003947",620,581,6,30,3,55,1,1,0,0,0,0,39,2,6,30,3,57,619,580,39
"N00003948",323,311,0,12,0,18,1,1,0,0,0,0,12,1,0,12,0,19,322,310,12
"N00003949",316,297,0,14,4,23,16,15,1,0,1,0,19,0,0,15,4,23,300,282,18
"N00003950",315,291,0,21,0,17,7,4,3,0,3,0,24,0,0,24,0,17,308,287,21
"N00003951",265,253,0,12,0,19,1,1,0,0,0,0,12,0,0,12,0,19,264,252,12
"N00003952",267,253,0,13,1,23,0,0,0,0,0,0,14,0,0,13,1,23,267,253,14
"N00003953",277,269,0,7,1,14,0,0,0,0,0,0,8,0,0,7,1,14,277,269,8
"N00003954",223,199,0,24,0,14,0,0,0,0,0,0,24,0,0,24,0,14,223,199,24
"N00003955",263,253,0,8,1,12,4,3,1,0,0,1,10,0,0,8,2,12,259,250,9
"N00003956",310,298,0,11,1,8,8,8,0,0,0,0,12,0,0,11,1,8,302,290,12
"N00003957",221,196,0,25,0,13,1,1,0,0,0,0,25,0,0,25,0,13,220,195,25
"N00003958",531,497,1,33,0,42,9,9,0,0,0,0,34,1,1,33,0,43,522,488,34
"N00003959",264,248,0,12,1,9,3,0,3,0,3,0,16,0,0,15,1,9,261,248,13
"N00003960",260,251,0,9,0,9,0,0,0,0,0,0,9,1,0,9,0,10,260,251,9
"N00003961",286,281,0,5,0,9,1,1,0,0,0,0,5,0,0,5,0,9,285,280,5
"N00003962",676,654,0,19,1,30,5,3,2,0,2,0,22,3,0,21,1,33,671,651,20
"N00003963",296,290,0,6,0,7,7,7,0,0,0,0,6,0,0,6,0,7,289,283,6
"N00003964",349,326,0,21,0,52,3,1,2,0,2,0,23,1,0,23,0,53,346,325,21
"N00003965",381,359,0,20,2,26,1,1,0,0,0,0,22,0,0,20,2,26,380,358,22
"N00003966",301,285,0,10,2,17,9,5,4,0,4,0,16,0,0,14,2,17,292,280,12
"N00003967",405,390,0,15,0,12,5,5,0,0,0,0,15,1,0,15,0,13,400,385,15
"N00003968",282,262,2,18,0,15,0,0,0,0,0,0,20,0,2,18,0,15,282,262,20
"N00003969",260,252,1,7,0,15,0,0,0,0,0,0,8,0,1,7,0,15,260,252,8
"N00003970",330,303,0,27,0,20,10,10,0,0,0,0,27,4,0,27,0,24,320,293,27
"N00003971",311,298,2,11,0,27,9,9,0,0,0,0,13,3,2,11,0,30,302,289,13
"N00003972",327,309,1,17,0,9,3,3,0,0,0,0,18,0,1,17,0,9,324,306,18
"N00003973",345,330,0,14,1,24,1,1,0,0,0,0,15,2,0,14,1,26,344,329,15
"N00003974",633,585,0,32,8,43,21,13,8,0,8,0,48,1,0,40,8,44,612,572,40
"N00003975",372,361,2,7,2,17,0,0,0,0,0,0,11,0,2,7,2,17,372,361,11
"N00003976",347,331,0,16,0,22,3,3,0,0,0,0,16,0,0,16,0,22,344,328,16
"N00003977",284,276,0,4,2,16,6,4,2,0,2,0,8,0,0,6,2,16,278,272,6
"N00003978",370,344,0,20,4,13,4,2,2,0,1,1,26,1,0,21,5,14,366,342,24
"N00003979",349,323,0,26,0,35,10,10,0,0,0,0,26,1,0,26,0,36,339,313,26
"N00003980",378,370,0,7,1,18,0,0,0,0,0,0,8,0,0,7,1,18,378,370,8
"N00003981",270,259,0,11,0,14,0,0,0,0,0,0,11,0,0,11,0,14,270,259,11
"N00003982",211,185,2,20,2,19,5,3,2,0,2,0,26,0,2,22,2,19,206,182,24
"N00003983",265,250,0,14,0,25,8,7,1,0,1,0,15,0,0,15,0,25,257,243,14
"N00003984",363,324,0,38,0,34,2,1,1,0,0,1,39,0,0,38,1,34,361,323,38
"N00003985",298,281,1,16,0,18,2,2,0,0,0,0,17,2,1,16,0,20,296,279,17
"N00003986",247,228,2,17,0,14,2,2,0,0,0,0,19,0,2,17,0,14,245,226,19
"N00003987",304,278,4,22,0,17,2,2,0,0,0,0,26,0,4,22,0,17,302,276,26
"N00003988",288,268,0,18,1,10,3,2,1,0,0,1,20,0,0,18,2,10,285,266,19
"N00003989",163,141,0,20,2,22,3,3,0,0,0,0,22,0,0,20,2,22,160,138,22
"N00003990",420,391,0,29,0,13,0,0,0,0,0,0,29,0,0,29,0,13,420,391,29
"N00003991",295,266,0,28,1,13,0,0,0,0,0,0,29,0,0,28,1,13,295,266,29
"N00003992",379,355,0,24,0,19,2,2,0,0,0,0,24,0,0,24,0,19,377,353,24
"N00003993",393,354,0,35,2,17,8,6,2,0,2,0,39,0,0,37,2,17,385,348,37
"N00003994",353,348,0,5,0,11,6,6,0,0,0,0,5,0,0,5,0,11,347,342,5
"N00003995",395,386,0,6,0,13,4,1,3,0,3,0,9,0,0,9,0,13,391,385,6
"N00003996",340,315,1,24,0,16,0,0,0,0,0,0,25,0,1,24,0,16,340,315,25
"N00003997",364,352,0,10,2,21,8,8,0,0,0,0,12,0,0,10,2,21,356,344,12
"N00003998",347,334,0,13,0,28,3,3,0,0,0,0,13,0,0,13,0,28,344,331,13
"N00003999",388,370,1,15,0,16,5,3,2,0,2,0,18,0,1,17,0,16,383,367,16
"N00004000",311,290,2,19,0,28,4,4,0,0,0,0,21,0,2,19,0,28,307,286,21
"N00004001",332,299,2,28,3,26,0,0,0,0,0,0,33,0,2,28,3,26,332,299,33
"N00004002",275,256,0,19,0,26,0,0,0,0,0,0,19,0,0,19,0,26,275,256,19
"N00004003",414,384,0,29,1,20,3,3,0,0,0,0,30,0,0,29,1,20,411,381,30
"N00004004",234,220,0,14,0,9,0,0,0,0,0,0,14,0,0,14,0,9,234,220,14
"N00004005",203,191,0,12,0,4,2,2,0,0,0,0,12,0,0,12,0,4,201,189,12
"N00004006",224,209,0,15,0,25,0,0,0,0,0,0,15,1,0,15,0,26,224,209,15
"N00004007",269,241,0,28,0,20,2,2,0,0,0,0,28,0,0,28,0,20,267,239,28
"N00004008",474,438,0,35,1,15,2,2,0,0,0,0,36,1,0,35,1,16,472,436,36
"N00004009",326,308,0,12,1,26,23,18,5,0,4,1,18,0,0,16,2,26,303,290,13
"N00004010",379,356,0,23,0,6,20,20,0,0,0,0,23,0,0,23,0,6,359,336,23
"N00004011",482,451,0,29,1,17,18,17,1,0,1,0,31,0,0,30,1,17,464,434,30
"N00004012",315,309,1,4,0,26,12,11,1,0,1,0,6,0,1,5,0,26,303,298,5
"N00004013",331,305,0,25,0,30,3,2,1,0,0,1,26,0,0,25,1,30,328,303,25
"N00004014",335,328,0,6,1,16,1,1,0,0,0,0,7,0,0,6,1,16,334,327,7
"N00004015",299,277,0,21,1,22,3,3,0,0,0,0,22,0,0,21,1,22,296,274,22
"N00004016",375,357,0,13,0,25,24,19,5,0,5,0,18,0,0,18,0,25,351,338,13
"N00004017",305,275,0,30,0,23,7,7,0,0,0,0,30,6,0,30,0,29,298,268,30
"N00004018",296,278,0,17,0,25,1,0,1,0,0,1,18,0,0,17,1,25,295,278,17
"N00004019",310,296,0,11,1,18,2,0,2,0,1,1,14,0,0,12,2,18,308,296,12
"N00004020",425,402,0,22,1,27,4,4,0,0,0,0,23,0,0,22,1,27,421,398,23
"N00004021",332,296,0,33,2,34,4,3,1,0,1,0,36,0,0,34,2,34,328,293,35
"N00004022",294,269,1,21,2,12,2,1,1,0,1,0,25,0,1,22,2,12,292,268,24
"N00004023",247,235,0,12,0,38,0,0,0,0,0,0,12,2,0,12,0,40,247,235,12
"N00004024",307,273,0,27,6,30,2,1,1,0,0,1,34,2,0,27,7,32,305,272,33
"N00004025",449,422,0,24,0,37,11,8,3,0,3,0,27,0,0,27,0,37,438,414,24
"N00004026",327,300,0,27,0,16,0,0,0,0,0,0,27,0,0,27,0,16,327,300,27
"N00004027",305,284,0,21,0,18,3,3,0,0,0,0,21,0,0,21,0,18,302,281,21
"N00004028",307,296,0,11,0,17,1,1,0,0,0,0,11,0,0,11,0,17,306,295,11
"N00004029",283,277,0,6,0,13,0,0,0,0,0,0,6,0,0,6,0,13,283,277,6
"N00004030",281,268,0,13,0,31,0,0,0,0,0,0,13,0,0,13,0,31,281,268,13
"N00004031",261,234,0,27,0,22,2,2,0,0,0,0,27,0,0,27,0,22,259,232,27
"N00004032",233,208,0,24,1,21,0,0,0,0,0,0,25,0,0,24,1,21,233,208,25
"N00004033",269,251,0,18,0,25,0,0,0,0,0,0,18,0,0,18,0,25,269,251,18
"N00004034",237,218,5,14,0,14,6,6,0,0,0,0,19,0,5,14,0,14,231,212,19
"N00004035",288,280,0,8,0,18,1,1,0,0,0,0,8,0,0,8,0,18,287,279,8
"N00004036",261,238,0,23,0,10,1,1,0,0,0,0,23,3,0,23,0,13,260,237,23
"N00004037",307,278,0,22,2,43,7,2,5,4,1,0,29,0,4,23,2,43,300,276,24
"N00004038",255,243,0,12,0,15,0,0,0,0,0,0,12,0,0,12,0,15,255,243,12
"N00004039",285,272,0,12,0,16,5,4,1,0,1,0,13,0,0,13,0,16,280,268,12
"N00004040",300,283,0,16,0,11,9,8,1,0,1,0,17,0,0,17,0,11,291,275,16
"N00004041",304,278,0,25,0,17,2,1,1,0,1,0,26,0,0,26,0,17,302,277,25
"N00004042",586,559,0,25,2,15,0,0,0,0,0,0,27,0,0,25,2,15,586,559,27
"N00004043",357,349,0,8,0,25,0,0,0,0,0,0,8,0,0,8,0,25,357,349,8
"N00004044",290,267,1,19,3,12,0,0,0,0,0,0,23,1,1,19,3,13,290,267,23
"N00004045",347,322,1,23,1,20,1,1,0,0,0,0,25,0,1,23,1,20,346,321,25
"N00004046",292,274,0,13,0,8,9,4,5,0,5,0,18,0,0,18,0,8,283,270,13
"N00004047",1081,1063,0,17,0,36,18,17,1,0,1,0,18,1,0,18,0,37,1063,1046,17
"N00004048",474,454,0,15,3,24,13,11,2,0,2,0,20,4,0,17,3,28,461,443,18
"N00004049",492,476,0,16,0,21,13,13,0,0,0,0,16,1,0,16,0,22,479,463,16
"N00004050",984,929,0,46,3,63,45,39,6,0,3,3,55,3,0,49,6,66,939,890,49
"N00004051",992,960,5,17,3,46,45,38,7,2,1,4,32,5,7,18,7,51,947,922,25
"N00004052",330,319,1,9,1,17,5,5,0,0,0,0,11,0,1,9,1,17,325,314,11
"N00004053",300,289,0,11,0,11,0,0,0,0,0,0,11,0,0,11,0,11,300,289,11
"N00004054",483,458,2,21,1,24,7,6,1,0,1,0,25,1,2,22,1,25,476,452,24
"N00004055",235,220,1,11,3,25,2,2,0,0,0,0,15,0,1,11,3,25,233,218,15
"N00004056",427,409,0,17,1,34,3,3,0,0,0,0,18,0,0,17,1,34,424,406,18
"N00004057",382,369,0,12,1,26,0,0,0,0,0,0,13,0,0,12,1,26,382,369,13
"N00004058",1248,1153,0,93,2,65,17,17,0,0,0,0,95,1,0,93,2,66,1231,1136,95
"N00004059",1463,1293,4,156,3,64,30,23,7,0,5,2,170,2,4,161,5,66,1433,1270,163
"N00004060",1223,1129,1,85,6,66,20,18,2,0,0,2,94,4,1,85,8,70,1203,1111,92
"N00004061",640,617,0,21,0,29,10,8,2,0,2,0,23,0,0,23,0,29,630,609,21
"N00004062",493,482,0,7,1,28,26,23,3,0,3,0,11,2,0,10,1,30,467,459,8
"N00004063",832,791,0,33,3,61,28,23,5,0,4,1,41,10,0,37,4,71,804,768,36
"N00004064",612,592,0,18,2,31,28,28,0,0,0,0,20,4,0,18,2,35,584,564,20
"N00004065",260,227,1,29,2,18,4,3,1,0,1,0,33,2,1,30,2,20,256,224,32
"N00004066",245,234,0,10,0,5,2,1,1,0,1,0,11,0,0,11,0,5,243,233,10
"N00004067",259,244,3,12,0,10,7,7,0,0,0,0,15,0,3,12,0,10,252,237,15
"N00004068",289,271,0,17,1,21,4,4,0,0,0,0,18,0,0,17,1,21,285,267,18
"N00004069",251,226,0,24,1,12,2,2,0,0,0,0,25,0,0,24,1,12,249,224,25
"N00004070",213,203,0,8,2,23,1,1,0,0,0,0,10,1,0,8,2,24,212,202,10
"N00004071",282,266,0,12,0,17,16,12,4,0,4,0,16,1,0,16,0,18,266,254,12
"N00004072",341,317,3,18,0,17,5,2,3,0,3,0,24,0,3,21,0,17,336,315,21
"N00004073",1068,1001,6,51,1,67,74,65,9,0,8,1,67,2,6,59,2,69,994,936,58
"N00004074",335,318,0,15,0,13,19,17,2,0,0,2,17,0,0,15,2,13,316,301,15
"N00004075",427,413,0,14,0,18,13,13,0,0,0,0,14,0,0,14,0,18,414,400,14
"N00004076",319,284,0,33,1,23,5,4,1,0,1,0,35,0,0,34,1,23,314,280,34
"N00004077",359,331,0,27,1,18,2,2,0,0,0,0,28,2,0,27,1,20,357,329,28
"N00004078",309,284,0,25,0,15,5,5,0,0,0,0,25,4,0,25,0,19,304,279,25
"N00004079",282,257,0,23,2,14,3,3,0,0,0,0,25,0,0,23,2,14,279,254,25
"N00004080",306,295,0,9,1,23,8,7,1,0,1,0,11,0,0,10,1,23,298,288,10
"N00004081",299,274,0,24,0,12,2,1,1,0,1,0,25,0,0,25,0,12,297,273,24
"N00004082",376,359,3,14,0,27,0,0,0,0,0,0,17,0,3,14,0,27,376,359,17
"N00004083",308,281,4,23,0,37,3,3,0,0,0,0,27,0,4,23,0,37,305,278,27
"N00004084",317,305,0,8,4,18,8,8,0,0,0,0,12,0,0,8,4,18,309,297,12
"N00004085",919,779,1,120,1,72,59,41,18,0,9,9,140,17,1,129,10,89,860,738,122
"N00004086",231,212,1,17,0,13,9,8,1,0,0,1,19,0,1,17,1,13,222,204,18
"N00004087",783,636,2,122,11,42,59,47,12,1,9,2,147,6,3,131,13,48,724,589,135
"N00004088",407,367,0,28,6,21,16,10,6,0,5,1,40,1,0,33,7,22,391,357,34
"N00004089",303,289,0,14,0,15,15,15,0,0,0,0,14,1,0,14,0,16,288,274,14
"N00004090",990,439,1,430,44,161,129,53,76,10,17,49,551,38,11,447,93,199,861,386,475
"N00004091",944,471,2,351,78,61,89,47,42,0,14,28,473,8,2,365,106,69,855,424,431
"N00004092",277,254,1,17,1,9,4,0,4,0,2,2,23,0,1,19,3,9,273,254,19
"N00004093",373,329,3,37,3,47,12,11,1,0,1,0,44,3,3,38,3,50,361,318,43
"N00004094",563,529,0,29,5,28,4,4,0,0,0,0,34,0,0,29,5,28,559,525,34
"N00004095",355,320,0,35,0,21,1,1,0,0,0,0,35,1,0,35,0,22,354,319,35
"N00004096",246,229,2,15,0,19,2,2,0,0,0,0,17,0,2,15,0,19,244,227,17
"N00004097",539,513,0,23,2,48,14,13,1,0,1,0,26,2,0,24,2,50,525,500,25
"N00004098",278,254,2,21,1,18,1,1,0,0,0,0,24,0,2,21,1,18,277,253,24
"N00004099",544,451,6,80,5,73,14,12,2,0,1,1,93,3,6,81,6,76,530,439,91
"N00004100",319,285,2,32,0,11,1,1,0,0,0,0,34,0,2,32,0,11,318,284,34
"N00004101",207,190,0,17,0,11,5,5,0,0,0,0,17,1,0,17,0,12,202,185,17
"N00004102",347,279,2,65,1,17,9,9,0,0,0,0,68,0,2,65,1,17,338,270,68
"N00004103",182,158,12,12,0,10,0,0,0,0,0,0,24,0,12,12,0,10,182,158,24
"N00004104",191,181,0,9,1,6,9,9,0,0,0,0,10,0,0,9,1,6,182,172,10
"N00004105",193,175,4,14,0,19,1,1,0,0,0,0,18,0,4,14,0,19,192,174,18
"N00004106",217,192,1,24,0,9,1,1,0,0,0,0,25,0,1,24,0,9,216,191,25
"N00004107",207,193,0,13,1,15,8,8,0,0,0,0,14,3,0,13,1,18,199,185,14
"N00004108",268,246,1,21,0,31,2,2,0,0,0,0,22,0,1,21,0,31,266,244,22
"N00004109",259,250,0,9,0,10,8,8,0,0,0,0,9,0,0,9,0,10,251,242,9
"N00004110",313,299,2,8,3,27,10,9,1,0,1,0,14,1,2,9,3,28,303,290,13
"N00004111",341,332,0,9,0,26,1,1,0,0,0,0,9,0,0,9,0,26,340,331,9
"N00004112",413,396,0,17,0,32,8,8,0,0,0,0,17,0,0,17,0,32,405,388,17
"N00004113",663,628,0,26,8,34,9,8,1,0,1,0,35,0,0,27,8,34,654,620,34
"N00004114",305,297,0,4,3,25,12,11,1,0,1,0,8,0,0,5,3,25,293,286,7
"N00004115",404,367,0,31,5,24,4,3,1,0,0,1,37,1,0,31,6,25,400,364,36
"N00004116",706,686,0,20,0,33,18,18,0,0,0,0,20,0,0,20,0,33,688,668,20
"N00004117",515,498,0,14,3,35,5,5,0,0,0,0,17,0,0,14,3,35,510,493,17
"N00004118",300,285,0,15,0,20,3,3,0,0,0,0,15,2,0,15,0,22,297,282,15
"N00004119",326,302,0,22,0,24,3,1,2,0,0,2,24,0,0,22,2,24,323,301,22
"N00004120",259,232,0,24,1,23,2,0,2,0,2,0,27,0,0,26,1,23,257,232,25
"N00004121",370,352,0,15,3,26,0,0,0,0,0,0,18,0,0,15,3,26,370,352,18
"N00004122",379,358,0,20,1,14,11,11,0,0,0,0,21,0,0,20,1,14,368,347,21
"N00004123",351,319,0,32,0,37,5,5,0,0,0,0,32,0,0,32,0,37,346,314,32
"N00004124",308,274,5,29,0,42,0,0,0,0,0,0,34,0,5,29,0,42,308,274,34
"N00004125",354,323,0,26,3,35,2,0,2,0,2,0,31,0,0,28,3,35,352,323,29
"N00004126",292,269,0,21,2,30,3,3,0,0,0,0,23,1,0,21,2,31,289,266,23
"N00004127",324,296,0,26,2,35,3,3,0,0,0,0,28,1,0,26,2,36,321,293,28
"N00004128",425,367,0,55,2,26,2,1,1,0,1,0,58,0,0,56,2,26,423,366,57
"N00004129",308,298,0,9,1,22,0,0,0,0,0,0,10,0,0,9,1,22,308,298,10
"N00004130",290,263,0,25,2,23,2,2,0,0,0,0,27,1,0,25,2,24,288,261,27
"N00004131",289,277,0,11,1,7,0,0,0,0,0,0,12,0,0,11,1,7,289,277,12
"N00004132",328,313,0,15,0,15,1,1,0,0,0,0,15,0,0,15,0,15,327,312,15
"N00004133",312,290,0,17,0,13,9,4,5,0,5,0,22,0,0,22,0,13,303,286,17
"N00004134",317,299,0,14,4,10,0,0,0,0,0,0,18,0,0,14,4,10,317,299,18
"N00004135",345,329,0,13,0,26,8,5,3,0,1,2,16,0,0,14,2,26,337,324,13
"N00004136",402,386,0,14,2,22,3,3,0,0,0,0,16,1,0,14,2,23,399,383,16
"N00004137",376,350,0,23,2,15,6,5,1,0,1,0,26,0,0,24,2,15,370,345,25
"N00004138",352,318,2,32,0,32,3,3,0,0,0,0,34,0,2,32,0,32,349,315,34
"N00004139",686,659,0,24,1,48,17,15,2,0,2,0,27,2,0,26,1,50,669,644,25
"N00004140",410,388,0,19,0,25,12,9,3,0,3,0,22,0,0,22,0,25,398,379,19
"N00004141",296,285,0,10,0,23,1,0,1,0,1,0,11,0,0,11,0,23,295,285,10
"N00004142",356,328,0,28,0,15,2,2,0,0,0,0,28,0,0,28,0,15,354,326,28
"N00004143",327,310,0,17,0,13,4,4,0,0,0,0,17,0,0,17,0,13,323,306,17
"N00004144",590,540,1,48,0,72,3,2,1,0,1,0,50,0,1,49,0,72,587,538,49
"N00004145",305,286,0,19,0,23,0,0,0,0,0,0,19,0,0,19,0,23,305,286,19
"N00004146",360,343,0,16,1,28,2,2,0,0,0,0,17,0,0,16,1,28,358,341,17
"N00004147",352,335,0,17,0,30,0,0,0,0,0,0,17,0,0,17,0,30,352,335,17
"N00004148",215,199,0,14,0,16,4,2,2,0,2,0,16,1,0,16,0,17,211,197,14
"N00004149",276,254,0,20,2,30,2,2,0,0,0,0,22,0,0,20,2,30,274,252,22
"N00004150",499,421,0,66,10,49,12,10,2,0,2,0,78,2,0,68,10,51,487,411,76
"N00004151",273,247,0,25,1,22,1,1,0,0,0,0,26,2,0,25,1,24,272,246,26
"N00004152",237,219,0,18,0,22,6,6,0,0,0,0,18,0,0,18,0,22,231,213,18
"N00004153",352,324,0,26,2,16,2,2,0,0,0,0,28,0,0,26,2,16,350,322,28
"N00004154",253,241,1,10,1,15,7,7,0,0,0,0,12,1,1,10,1,16,246,234,12
"N00004155",290,260,0,27,2,19,8,7,1,0,1,0,30,0,0,28,2,19,282,253,29
"N00004156",232,211,1,20,0,10,8,8,0,0,0,0,21,0,1,20,0,10,224,203,21
"N00004157",473,428,0,43,1,40,5,4,1,0,1,0,45,0,0,44,1,40,468,424,44
"N00004158",418,399,0,19,0,42,2,2,0,0,0,0,19,0,0,19,0,42,416,397,19
"N00004159",130,105,0,24,1,16,0,0,0,0,0,0,25,0,0,24,1,16,130,105,25
"N00004160",202,191,0,11,0,16,3,3,0,0,0,0,11,0,0,11,0,16,199,188,11
"N00004161",299,265,0,31,0,46,8,5,3,0,3,0,34,2,0,34,0,48,291,260,31
"N00004162",202,180,0,20,1,4,1,0,1,0,0,1,22,0,0,20,2,4,201,180,21
"N00004163",388,368,2,16,2,29,6,6,0,0,0,0,20,2,2,16,2,31,382,362,20
"N00004164",407,384,0,19,2,21,16,14,2,0,0,2,23,0,0,19,4,21,391,370,21
"N00004165",424,399,0,23,1,20,12,11,1,0,1,0,25,6,0,24,1,26,412,388,24
"N00004166",252,219,0,28,0,31,11,6,5,0,4,1,33,3,0,32,1,34,241,213,28
"N00004167",379,337,1,39,1,49,11,10,1,0,1,0,42,2,1,40,1,51,368,327,41
"N00004168",204,180,0,24,0,12,0,0,0,0,0,0,24,0,0,24,0,12,204,180,24
"N00004169",313,286,0,26,0,22,2,1,1,0,0,1,27,3,0,26,1,25,311,285,26
"N00004170",292,279,2,9,2,27,9,9,0,0,0,0,13,0,2,9,2,27,283,270,13
"N00004171",309,287,0,12,10,23,2,2,0,0,0,0,22,0,0,12,10,23,307,285,22
"N00004172",247,230,0,15,1,5,4,3,1,0,1,0,17,0,0,16,1,5,243,227,16
"N00004173",259,231,0,25,3,17,11,11,0,0,0,0,28,0,0,25,3,17,248,220,28
"N00004174",273,253,0,20,0,18,5,5,0,0,0,0,20,0,0,20,0,18,268,248,20
"N00004175",280,254,1,20,5,28,1,1,0,0,0,0,26,3,1,20,5,31,279,253,26
"N00004176",406,377,5,23,1,39,5,5,0,0,0,0,29,0,5,23,1,39,401,372,29
"N00004177",156,135,1,19,1,13,0,0,0,0,0,0,21,0,1,19,1,13,156,135,21
"N00004178",310,292,0,13,4,13,3,2,1,0,0,1,18,0,0,13,5,13,307,290,17
"N00004179",344,330,0,11,2,14,3,2,1,0,0,1,14,0,0,11,3,14,341,328,13
"N00004180",273,261,0,11,1,19,7,7,0,0,0,0,12,0,0,11,1,19,266,254,12
"N00004181",267,244,0,23,0,12,0,0,0,0,0,0,23,0,0,23,0,12,267,244,23
"N00004182",341,330,0,11,0,18,4,4,0,0,0,0,11,2,0,11,0,20,337,326,11
"N00004183",98,86,0,12,0,7,1,1,0,0,0,0,12,0,0,12,0,7,97,85,12
"N00004184",260,253,0,7,0,10,2,2,0,0,0,0,7,0,0,7,0,10,258,251,7
"N00004185",702,660,0,38,2,24,9,7,2,0,2,0,42,1,0,40,2,25,693,653,40
"N00004186",305,270,2,29,0,10,10,6,4,0,1,3,35,1,2,30,3,11,295,264,31
"N00004187",382,336,0,44,2,33,3,3,0,0,0,0,46,1,0,44,2,34,379,333,46
"N00004188",289,267,0,22,0,25,4,4,0,0,0,0,22,0,0,22,0,25,285,263,22
"N00004189",212,196,0,15,1,15,3,3,0,0,0,0,16,0,0,15,1,15,209,193,16
"N00004190",486,455,0,30,1,37,3,3,0,0,0,0,31,0,0,30,1,37,483,452,31
"N00004191",598,540,2,49,7,59,6,6,0,0,0,0,58,1,2,49,7,60,592,534,58
"N00004192",295,274,0,18,1,11,6,4,2,0,0,2,21,2,0,18,3,13,289,270,19
"N00004193",290,264,0,26,0,7,1,1,0,0,0,0,26,0,0,26,0,7,289,263,26
"N00004194",265,242,0,22,1,17,1,1,0,0,0,0,23,0,0,22,1,17,264,241,23
"N00004195",276,248,0,26,0,21,2,0,2,0,2,0,28,0,0,28,0,21,274,248,26
"N00004196",1009,937,0,67,0,41,9,4,5,0,5,0,72,3,0,72,0,44,1000,933,67
"N00004197",245,225,1,19,0,31,2,2,0,0,0,0,20,0,1,19,0,31,243,223,20
"N00004198",247,220,0,24,0,24,3,0,3,0,3,0,27,0,0,27,0,24,244,220,24
"N00004199",798,710,5,74,5,61,17,13,4,0,4,0,88,3,5,78,5,64,781,697,84
"N00004200",395,370,0,24,1,20,8,8,0,0,0,0,25,0,0,24,1,20,387,362,25
"N00004201",327,309,0,17,0,35,17,16,1,0,1,0,18,0,0,18,0,35,310,293,17
"N00004202",342,320,1,21,0,23,7,7,0,0,0,0,22,0,1,21,0,23,335,313,22
"N00004203",373,335,0,37,0,34,5,4,1,0,1,0,38,0,0,38,0,34,368,331,37
"N00004204",314,278,3,33,0,38,3,3,0,0,0,0,36,2,3,33,0,40,311,275,36
"N00004205",285,256,0,23,6,22,0,0,0,0,0,0,29,0,0,23,6,22,285,256,29
"N00004206",283,255,1,26,0,30,7,6,1,0,1,0,28,0,1,27,0,30,276,249,27
"N00004207",331,296,2,33,0,27,0,0,0,0,0,0,35,0,2,33,0,27,331,296,35
"N00004208",484,427,1,56,0,42,1,1,0,0,0,0,57,0,1,56,0,42,483,426,57
"N00004209",648,610,0,38,0,58,7,7,0,0,0,0,38,4,0,38,0,62,641,603,38
"N00004210",312,291,0,21,0,14,9,9,0,0,0,0,21,0,0,21,0,14,303,282,21
"N00004211",674,590,2,80,2,51,7,7,0,0,0,0,84,0,2,80,2,51,667,583,84
"N00004212",1948,1743,3,194,3,126,29,24,5,0,4,1,205,3,3,198,4,129,1919,1719,200
"N00004213",321,284,0,36,1,40,5,5,0,0,0,0,37,1,0,36,1,41,316,279,37
"N00004214",280,248,0,29,3,28,11,11,0,0,0,0,32,2,0,29,3,30,269,237,32
"N00004215",324,304,0,16,3,23,9,8,1,0,1,0,20,0,0,17,3,23,315,296,19
"N00004216",420,368,0,49,1,57,4,2,2,0,1,1,52,6,0,50,2,63,416,366,50
"N00004217",247,218,1,27,0,12,2,1,1,1,0,0,29,1,2,27,0,13,245,217,28
"N00004218",274,223,0,49,0,12,2,0,2,0,2,0,51,0,0,51,0,12,272,223,49
"N00004219",318,301,0,13,2,32,9,7,2,0,1,1,17,0,0,14,3,32,309,294,15
"N00004220",298,284,0,9,4,15,4,3,1,0,0,1,14,2,0,9,5,17,294,281,13
"N00004221",325,307,0,17,1,21,4,4,0,0,0,0,18,0,0,17,1,21,321,303,18
"N00004222",335,320,0,15,0,21,2,2,0,0,0,0,15,0,0,15,0,21,333,318,15
"N00004223",261,229,0,32,0,9,0,0,0,0,0,0,32,0,0,32,0,9,261,229,32
"N00004224",302,282,2,15,2,22,8,7,1,0,1,0,20,2,2,16,2,24,294,275,19
"N00004225",270,251,0,19,0,32,8,8,0,0,0,0,19,0,0,19,0,32,262,243,19
"N00004226",431,389,1,28,12,17,10,9,1,0,1,0,42,1,1,29,12,18,421,380,41
"N00004227",265,254,0,11,0,13,9,9,0,0,0,0,11,0,0,11,0,13,256,245,11
"N00004228",732,681,7,32,10,48,19,17,2,0,2,0,51,8,7,34,10,56,713,664,49
"N00004229",326,295,0,18,11,34,5,3,2,0,1,1,31,2,0,19,12,36,321,292,29
"N00004230",286,277,0,9,0,10,6,6,0,0,0,0,9,0,0,9,0,10,280,271,9
"N00004231",306,291,0,14,1,15,2,2,0,0,0,0,15,0,0,14,1,15,304,289,15
"N00004232",246,240,0,6,0,8,4,4,0,0,0,0,6,1,0,6,0,9,242,236,6
"N00004233",347,327,0,19,1,16,5,5,0,0,0,0,20,0,0,19,1,16,342,322,20
"N00004234",262,238,0,24,0,17,1,1,0,0,0,0,24,0,0,24,0,17,261,237,24
"N00004235",294,278,0,15,1,19,0,0,0,0,0,0,16,0,0,15,1,19,294,278,16
"N00004236",309,272,3,26,3,38,15,10,5,0,5,0,37,0,3,31,3,38,294,262,32
"N00004237",278,244,0,29,5,21,1,1,0,0,0,0,34,0,0,29,5,21,277,243,34
"N00004238",346,299,0,47,0,38,10,10,0,0,0,0,47,3,0,47,0,41,336,289,47
"N00004239",272,269,0,3,0,44,13,13,0,0,0,0,3,0,0,3,0,44,259,256,3
"N00004240",340,279,2,54,4,39,2,1,1,0,1,0,61,1,2,55,4,40,338,278,60
"N00004241",274,262,0,11,1,27,0,0,0,0,0,0,12,0,0,11,1,27,274,262,12
"N00004242",364,338,0,22,3,20,5,4,1,0,1,0,26,1,0,23,3,21,359,334,25
"N00004243",279,255,0,23,1,15,4,4,0,0,0,0,24,0,0,23,1,15,275,251,24
"N00004244",194,180,0,14,0,15,1,1,0,0,0,0,14,0,0,14,0,15,193,179,14
"N00004245",334,286,0,44,3,30,5,4,1,0,1,0,48,0,0,45,3,30,329,282,47
"N00004246",322,304,0,18,0,22,1,1,0,0,0,0,18,0,0,18,0,22,321,303,18
"N00004247",315,294,0,21,0,8,0,0,0,0,0,0,21,0,0,21,0,8,315,294,21
"N00004248",236,208,0,28,0,27,1,1,0,0,0,0,28,0,0,28,0,27,235,207,28
"N00004249",258,243,0,15,0,8,1,1,0,0,0,0,15,0,0,15,0,8,257,242,15
"N00004250",244,212,0,29,1,26,4,2,2,0,2,0,32,0,0,31,1,26,240,210,30
"N00004251",267,246,3,16,0,19,5,3,2,0,1,1,21,0,3,17,1,19,262,243,19
"N00004252",302,296,0,6,0,54,10,10,0,0,0,0,6,0,0,6,0,54,292,286,6
"N00004253",293,266,0,22,1,25,4,0,4,0,4,0,27,0,0,26,1,25,289,266,23
"N00004254",284,275,0,9,0,19,1,1,0,0,0,0,9,0,0,9,0,19,283,274,9
"N00004255",219,213,2,3,0,8,1,0,1,0,1,0,6,0,2,4,0,8,218,213,5
"N00004256",860,772,7,74,6,74,10,9,1,0,1,0,88,7,7,75,6,81,850,763,87
"N00004257",226,210,0,16,0,3,4,4,0,0,0,0,16,0,0,16,0,3,222,206,16
"N00004258",308,269,1,37,1,10,2,2,0,0,0,0,39,0,1,37,1,10,306,267,39
"N00004259",199,187,0,10,2,27,2,2,0,0,0,0,12,0,0,10,2,27,197,185,12
"N00004260",314,295,0,19,0,17,0,0,0,0,0,0,19,0,0,19,0,17,314,295,19
"N00004261",233,207,1,21,2,34,12,10,2,0,2,0,26,0,1,23,2,34,221,197,24
"N00004262",281,196,0,77,4,30,6,2,4,1,0,3,85,0,1,77,7,30,275,194,81
"N00004263",226,164,1,46,7,42,15,7,8,0,8,0,62,5,1,54,7,47,211,157,54
"N00004264",533,406,8,105,9,68,28,23,5,2,2,1,127,5,10,107,10,73,505,383,122
"N00004265",222,170,0,43,4,35,7,2,5,0,3,2,52,0,0,46,6,35,215,168,47
"N00004266",324,302,0,20,0,25,5,3,2,0,2,0,22,0,0,22,0,25,319,299,20
"N00004267",562,487,2,62,3,51,15,7,8,0,7,1,75,3,2,69,4,54,547,480,67
"N00004268",324,287,0,34,3,54,6,6,0,0,0,0,37,0,0,34,3,54,318,281,37
"N00004269",317,272,2,35,4,24,11,7,4,0,4,0,45,0,2,39,4,24,306,265,41
"N00004270",461,361,1,83,10,39,24,18,6,0,3,3,100,1,1,86,13,40,437,343,94
"N00004271",291,240,0,44,0,36,13,6,7,0,7,0,51,0,0,51,0,36,278,234,44
"N00004272",252,210,0,38,1,54,7,4,3,0,2,1,42,4,0,40,2,58,245,206,39
"N00004273",397,339,2,48,2,38,13,7,6,5,1,0,58,22,7,49,2,60,384,332,52
"N00004274",296,265,0,30,1,33,1,1,0,0,0,0,31,0,0,30,1,33,295,264,31
"N00004275",277,221,3,45,4,34,8,4,4,0,3,1,56,0,3,48,5,34,269,217,52
"N00004276",458,406,0,27,19,20,9,3,6,0,6,0,52,0,0,33,19,20,449,403,46
"N00004277",309,289,0,14,6,26,2,2,0,0,0,0,20,2,0,14,6,28,307,287,20
"N00004278",271,238,0,30,3,15,0,0,0,0,0,0,33,0,0,30,3,15,271,238,33
"N00004279",325,288,0,35,2,26,6,6,0,0,0,0,37,8,0,35,2,34,319,282,37
"N00004280",318,299,0,18,1,37,5,5,0,0,0,0,19,0,0,18,1,37,313,294,19
"N00004281",424,396,0,24,0,29,14,10,4,0,4,0,28,0,0,28,0,29,410,386,24
"N00004282",229,208,1,16,0,16,4,0,4,0,2,2,21,2,1,18,2,18,225,208,17
"N00004283",340,311,0,17,7,26,7,2,5,0,0,5,29,0,0,17,12,26,333,309,24
"N00004284",364,336,0,27,1,23,1,1,0,0,0,0,28,0,0,27,1,23,363,335,28
"N00004285",358,336,0,20,2,25,4,4,0,0,0,0,22,3,0,20,2,28,354,332,22
"N00004286",317,306,0,6,4,67,5,4,1,0,1,0,11,8,0,7,4,75,312,302,10
"N00004287",615,569,3,34,9,86,14,14,0,0,0,0,46,6,3,34,9,92,601,555,46
"N00004288",220,205,1,13,0,27,5,4,1,0,1,0,15,0,1,14,0,27,215,201,14
"N00004289",220,204,0,16,0,17,4,4,0,0,0,0,16,0,0,16,0,17,216,200,16
"N00004290",583,530,0,53,0,41,2,2,0,0,0,0,53,1,0,53,0,42,581,528,53
"N00004291",343,328,2,11,1,18,13,12,1,0,1,0,15,5,2,12,1,23,330,316,14
"N00004292",204,182,0,12,5,12,11,6,5,0,3,2,22,0,0,15,7,12,193,176,17
"N00004293",236,192,0,35,2,23,18,11,7,0,2,5,44,1,0,37,7,24,218,181,37
"N00004294",1013,638,5,290,35,164,113,68,45,15,15,15,375,18,20,305,50,182,900,570,330
"N00004295",271,255,0,11,4,20,1,0,1,0,1,0,16,1,0,12,4,21,270,255,15
"N00004296",348,304,0,38,6,13,0,0,0,0,0,0,44,0,0,38,6,13,348,304,44
"N00004297",329,288,2,33,4,36,4,2,2,0,1,1,41,0,2,34,5,36,325,286,39
"N00004298",391,373,0,16,0,24,7,5,2,0,1,1,18,0,0,17,1,24,384,368,16
"N00004299",540,501,0,38,1,36,3,3,0,0,0,0,39,0,0,38,1,36,537,498,39
"N00004300",175,164,0,11,0,15,0,0,0,0,0,0,11,0,0,11,0,15,175,164,11
"N00004301",362,337,0,21,3,18,2,1,1,0,1,0,25,3,0,22,3,21,360,336,24
"N00004302",430,390,5,33,2,15,5,5,0,0,0,0,40,1,5,33,2,16,425,385,40
"N00004303",270,260,0,10,0,15,6,6,0,0,0,0,10,0,0,10,0,15,264,254,10
"N00004304",308,293,0,15,0,24,3,3,0,0,0,0,15,0,0,15,0,24,305,290,15
"N00004305",253,249,0,3,0,6,4,3,1,0,1,0,4,2,0,4,0,8,249,246,3
"N00004306",390,319,1,55,1,54,17,3,14,0,10,4,71,2,1,65,5,56,373,316,57
"N00004307",254,220,2,31,1,34,13,13,0,0,0,0,34,2,2,31,1,36,241,207,34
"N00004308",262,245,0,12,0,37,13,8,5,0,5,0,17,0,0,17,0,37,249,237,12
"N00004309",235,232,0,3,0,9,4,4,0,0,0,0,3,0,0,3,0,9,231,228,3
"N00004310",243,232,0,8,2,18,1,0,1,0,1,0,11,0,0,9,2,18,242,232,10
"N00004311",215,174,0,39,1,41,2,1,1,0,1,0,41,5,0,40,1,46,213,173,40
"N00004312",304,278,0,22,0,13,9,5,4,0,0,4,26,5,0,22,4,18,295,273,22
"N00004313",323,281,0,40,1,35,10,9,1,0,1,0,42,2,0,41,1,37,313,272,41
"N00004314",616,520,4,81,4,86,43,36,7,1,4,2,96,4,5,85,6,90,573,484,89
"N00004315",240,210,0,29,1,20,0,0,0,0,0,0,30,0,0,29,1,20,240,210,30
"N00004316",285,268,0,15,0,20,17,15,2,0,2,0,17,1,0,17,0,21,268,253,15
"N00004317",269,243,0,26,0,31,11,11,0,0,0,0,26,1,0,26,0,32,258,232,26
"N00004318",256,234,0,19,1,14,10,8,2,0,2,0,22,0,0,21,1,14,246,226,20
"N00004319",285,258,0,17,3,19,41,34,7,0,4,3,27,10,0,21,6,29,244,224,20
"N00004320",362,243,5,102,6,28,12,6,6,0,5,1,119,4,5,107,7,32,350,237,113
"N00004321",650,627,0,22,1,31,8,8,0,0,0,0,23,0,0,22,1,31,642,619,23
"N00004322",324,315,0,8,0,18,11,10,1,0,1,0,9,0,0,9,0,18,313,305,8
"N00004323",362,334,0,27,1,30,5,5,0,0,0,0,28,1,0,27,1,31,357,329,28
"N00004324",247,225,0,22,0,18,4,4,0,0,0,0,22,0,0,22,0,18,243,221,22
"N00004325",271,243,0,25,1,28,9,7,2,0,0,2,28,1,0,25,3,29,262,236,26
"N00004326",287,266,0,12,2,16,14,7,7,0,1,6,21,0,0,13,8,16,273,259,14
"N00004327",274,252,0,22,0,26,8,8,0,0,0,0,22,0,0,22,0,26,266,244,22
"N00004328",290,272,0,15,0,23,9,6,3,0,3,0,18,1,0,18,0,24,281,266,15
"N00004329",274,242,0,32,0,19,1,1,0,0,0,0,32,0,0,32,0,19,273,241,32
"N00004330",290,274,0,16,0,27,6,6,0,0,0,0,16,0,0,16,0,27,284,268,16
"N00004331",299,268,3,25,3,16,3,3,0,0,0,0,31,4,3,25,3,20,296,265,31
"N00004332",331,309,0,21,1,33,0,0,0,0,0,0,22,0,0,21,1,33,331,309,22
"N00004333",257,235,0,22,0,19,1,1,0,0,0,0,22,1,0,22,0,20,256,234,22
"N00004334",231,215,0,15,1,14,0,0,0,0,0,0,16,0,0,15,1,14,231,215,16
"N00004335",220,206,0,14,0,21,0,0,0,0,0,0,14,0,0,14,0,21,220,206,14
"N00004336",318,282,0,34,0,21,10,8,2,0,2,0,36,0,0,36,0,21,308,274,34
"N00004337",249,219,0,24,5,23,6,5,1,0,0,1,30,0,0,24,6,23,243,214,29
"N00004338",369,355,4,10,0,9,4,4,0,0,0,0,14,0,4,10,0,9,365,351,14
"N00004339",539,522,0,16,1,30,0,0,0,0,0,0,17,0,0,16,1,30,539,522,17
"N00004340",440,416,3,20,1,29,0,0,0,0,0,0,24,0,3,20,1,29,440,416,24
"N00004341",433,411,1,19,2,16,0,0,0,0,0,0,22,0,1,19,2,16,433,411,22
"N00004342",727,663,7,43,13,26,10,9,1,0,1,0,64,0,7,44,13,26,717,654,63
"N00004343",269,259,0,10,0,50,0,0,0,0,0,0,10,0,0,10,0,50,269,259,10
"N00004344",273,249,0,23,1,19,6,6,0,0,0,0,24,0,0,23,1,19,267,243,24
"N00004345",438,381,2,54,1,28,8,8,0,0,0,0,57,0,2,54,1,28,430,373,57
"N00004346",378,355,0,21,2,15,4,4,0,0,0,0,23,0,0,21,2,15,374,351,23
"N00004347",459,428,0,23,7,32,11,10,1,0,1,0,31,0,0,24,7,32,448,418,30
"N00004348",214,203,0,10,1,20,1,1,0,0,0,0,11,1,0,10,1,21,213,202,11
"N00004349",252,234,0,15,2,20,7,6,1,0,0,1,18,0,0,15,3,20,245,228,17
"N00004350",1152,1088,4,54,6,58,14,14,0,0,0,0,64,1,4,54,6,59,1138,1074,64
"N00004351",539,507,3,29,0,20,0,0,0,0,0,0,32,0,3,29,0,20,539,507,32
"N00004352",607,578,0,29,0,27,5,5,0,0,0,0,29,0,0,29,0,27,602,573,29
"N00004353",492,464,1,26,1,22,0,0,0,0,0,0,28,0,1,26,1,22,492,464,28
"N00004354",387,369,4,13,1,13,4,4,0,0,0,0,18,0,4,13,1,13,383,365,18
"N00004355",353,325,0,21,7,36,0,0,0,0,0,0,28,0,0,21,7,36,353,325,28
"N00004356",286,261,2,19,3,35,6,5,1,0,0,1,25,4,2,19,4,39,280,256,24
"N00004357",1457,1371,8,66,12,67,12,12,0,0,0,0,86,2,8,66,12,69,1445,1359,86
"N00004358",298,285,1,5,7,12,2,2,0,0,0,0,13,1,1,5,7,13,296,283,13
"N00004359",1095,984,0,101,8,84,21,19,2,0,2,0,111,1,0,103,8,85,1074,965,109
"N00004360",494,471,0,14,8,33,11,10,1,0,1,0,23,1,0,15,8,34,483,461,22
"N00004361",505,425,8,59,11,59,10,8,2,0,2,0,80,1,8,61,11,60,495,417,78
"N00004362",676,632,5,35,1,49,12,9,3,0,3,0,44,0,5,38,1,49,664,623,41
"N00004363",472,452,1,17,1,22,1,0,1,0,0,1,20,0,1,17,2,22,471,452,19
"N00004364",418,408,0,8,2,23,0,0,0,0,0,0,10,2,0,8,2,25,418,408,10
"N00004365",548,511,3,33,0,55,10,9,1,0,1,0,37,0,3,34,0,55,538,502,36
"N00004366",268,243,0,19,6,13,2,2,0,0,0,0,25,0,0,19,6,13,266,241,25
"N00004367",688,632,6,43,6,41,4,3,1,0,1,0,56,0,6,44,6,41,684,629,55
"N00004368",494,458,0,35,1,19,1,1,0,0,0,0,36,1,0,35,1,20,493,457,36
"N00004369",403,396,0,7,0,25,1,1,0,0,0,0,7,0,0,7,0,25,402,395,7
"N00004370",601,545,7,38,10,31,8,7,1,0,1,0,56,0,7,39,10,31,593,538,55
"N00004371",442,417,2,18,5,9,1,1,0,0,0,0,25,0,2,18,5,9,441,416,25
"N00004372",486,473,0,10,3,16,0,0,0,0,0,0,13,0,0,10,3,16,486,473,13
"N00004373",490,460,3,25,2,25,0,0,0,0,0,0,30,0,3,25,2,25,490,460,30
"N00004374",469,439,1,28,1,23,0,0,0,0,0,0,30,0,1,28,1,23,469,439,30
"N00004375",849,794,11,36,7,39,7,6,1,0,0,1,55,1,11,36,8,40,842,788,54
"N00004376",448,426,0,22,0,20,2,2,0,0,0,0,22,0,0,22,0,20,446,424,22
"N00004377",465,450,0,13,2,25,6,6,0,0,0,0,15,0,0,13,2,25,459,444,15
"N00004378",211,153,6,35,17,40,18,18,0,0,0,0,58,2,6,35,17,42,193,135,58
"N00004379",267,244,3,20,0,27,1,1,0,0,0,0,23,0,3,20,0,27,266,243,23
"N00004380",310,295,0,15,0,13,5,5,0,0,0,0,15,5,0,15,0,18,305,290,15
"N00004381",292,266,0,23,3,18,7,7,0,0,0,0,26,1,0,23,3,19,285,259,26
"N00004382",438,379,2,53,2,42,11,9,2,0,2,0,59,1,2,55,2,43,427,370,57
"N00004383",275,246,1,21,7,28,3,3,0,0,0,0,29,2,1,21,7,30,272,243,29
"N00004384",251,239,0,11,1,34,1,1,0,0,0,0,12,0,0,11,1,34,250,238,12
"N00004385",271,256,0,9,0,23,13,7,6,0,6,0,15,0,0,15,0,23,258,249,9
"N00004386",438,420,3,15,0,18,5,5,0,0,0,0,18,0,3,15,0,18,433,415,18
"N00004387",348,342,1,5,0,20,0,0,0,0,0,0,6,0,1,5,0,20,348,342,6
"N00004388",427,411,0,13,3,20,1,1,0,0,0,0,16,0,0,13,3,20,426,410,16
"N00004389",490,467,0,22,1,42,1,1,0,0,0,0,23,0,0,22,1,42,489,466,23
"N00004390",439,418,0,20,1,27,0,0,0,0,0,0,21,0,0,20,1,27,439,418,21
"N00004391",497,475,0,21,1,18,0,0,0,0,0,0,22,0,0,21,1,18,497,475,22
"N00004392",352,340,0,12,0,25,0,0,0,0,0,0,12,0,0,12,0,25,352,340,12
"N00004393",314,296,1,14,3,20,0,0,0,0,0,0,18,0,1,14,3,20,314,296,18
"N00004394",205,182,3,17,3,20,0,0,0,0,0,0,23,0,3,17,3,20,205,182,23
"N00004395",232,220,1,9,2,13,0,0,0,0,0,0,12,0,1,9,2,13,232,220,12
"N00004396",446,419,2,19,5,25,1,0,1,0,1,0,27,0,2,20,5,25,445,419,26
"N00004397",342,309,2,20,11,10,0,0,0,0,0,0,33,0,2,20,11,10,342,309,33
"N00004398",539,511,0,21,7,13,1,1,0,0,0,0,28,0,0,21,7,13,538,510,28
"N00004399",672,627,0,42,3,37,3,3,0,0,0,0,45,0,0,42,3,37,669,624,45
"N00004400",531,502,2,24,3,12,0,0,0,0,0,0,29,0,2,24,3,12,531,502,29
"N00004401",752,649,3,80,20,60,7,7,0,0,0,0,103,0,3,80,20,60,745,642,103
"N00004402",1134,1041,16,69,7,64,15,14,1,0,0,1,93,3,16,69,8,67,1119,1027,92
"N00004403",354,319,5,30,0,55,0,0,0,0,0,0,35,0,5,30,0,55,354,319,35
"N00004404",709,666,0,42,1,33,3,3,0,0,0,0,43,1,0,42,1,34,706,663,43
"N00004405",636,608,0,25,3,38,6,6,0,0,0,0,28,1,0,25,3,39,630,602,28
"N00004406",421,376,5,33,7,31,3,3,0,0,0,0,45,2,5,33,7,33,418,373,45
"N00004407",344,331,0,12,0,20,3,2,1,0,0,1,13,0,0,12,1,20,341,329,12
"N00004408",317,288,0,28,1,12,3,3,0,0,0,0,29,0,0,28,1,12,314,285,29
"N00004409",450,421,0,27,2,16,11,11,0,0,0,0,29,0,0,27,2,16,439,410,29
"N00004410",656,597,2,53,4,43,15,15,0,0,0,0,59,0,2,53,4,43,641,582,59
"N00004411",476,437,0,36,3,62,7,7,0,0,0,0,39,0,0,36,3,62,469,430,39
"N00004412",432,353,4,74,1,52,3,3,0,0,0,0,79,0,4,74,1,52,429,350,79
"N00004413",210,183,0,20,7,18,1,1,0,0,0,0,27,0,0,20,7,18,209,182,27
"N00004414",154,137,0,17,0,34,4,4,0,0,0,0,17,2,0,17,0,36,150,133,17
"N00004415",1041,952,17,58,14,73,18,18,0,0,0,0,89,0,17,58,14,73,1023,934,89
"N00004416",628,563,1,53,11,48,13,13,0,0,0,0,65,4,1,53,11,52,615,550,65
"N00004417",506,486,1,18,1,30,4,4,0,0,0,0,20,0,1,18,1,30,502,482,20
"N00004418",517,489,6,18,4,10,0,0,0,0,0,0,28,0,6,18,4,10,517,489,28
"N00004419",468,443,1,20,4,22,1,1,0,0,0,0,25,0,1,20,4,22,467,442,25
"N00004420",527,509,6,10,2,20,0,0,0,0,0,0,18,3,6,10,2,23,527,509,18
"N00004421",374,347,5,21,1,10,0,0,0,0,0,0,27,0,5,21,1,10,374,347,27
"N00004422",493,475,0,15,3,25,0,0,0,0,0,0,18,0,0,15,3,25,493,475,18
"N00004423",466,457,1,7,1,5,2,2,0,0,0,0,9,0,1,7,1,5,464,455,9
"N00004424",400,383,0,15,2,21,1,1,0,0,0,0,17,0,0,15,2,21,399,382,17
"N00004425",513,479,0,27,7,19,4,4,0,0,0,0,34,0,0,27,7,19,509,475,34
"N00004426",478,468,3,6,1,19,0,0,0,0,0,0,10,0,3,6,1,19,478,468,10
"N00004427",397,373,8,16,0,26,0,0,0,0,0,0,24,0,8,16,0,26,397,373,24
"N00004428",394,385,0,9,0,15,1,1,0,0,0,0,9,0,0,9,0,15,393,384,9
"N00004429",539,518,0,19,1,27,1,0,1,0,1,0,21,0,0,20,1,27,538,518,20
"N00004430",539,506,3,25,3,36,7,5,2,0,0,2,33,0,3,25,5,36,532,501,31
"N00004431",505,471,1,33,0,13,5,5,0,0,0,0,34,0,1,33,0,13,500,466,34
"N00004432",130,115,0,10,5,13,0,0,0,0,0,0,15,0,0,10,5,13,130,115,15
"N00004433",610,564,0,29,15,44,16,14,2,0,0,2,46,0,0,29,17,44,594,550,44
"N00004434",412,354,0,43,13,21,2,0,2,0,0,2,58,1,0,43,15,22,410,354,56
"N00004435",344,306,0,29,7,36,5,3,2,0,2,0,38,0,0,31,7,36,339,303,36
"N00004436",377,356,0,16,5,20,0,0,0,0,0,0,21,1,0,16,5,21,377,356,21
"N00004437",317,300,1,12,3,22,6,5,1,0,0,1,17,0,1,12,4,22,311,295,16
"N00004438",548,532,1,13,2,16,9,9,0,0,0,0,16,0,1,13,2,16,539,523,16
"N00004439",561,544,0,14,3,17,10,10,0,0,0,0,17,0,0,14,3,17,551,534,17
"N00004440",527,506,0,17,4,14,1,1,0,0,0,0,21,0,0,17,4,14,526,505,21
"N00004441",550,525,0,24,1,33,0,0,0,0,0,0,25,0,0,24,1,33,550,525,25
"N00004442",545,508,0,30,3,19,4,0,4,0,4,0,37,0,0,34,3,19,541,508,33
"N00004443",612,566,5,34,6,18,6,5,1,0,1,0,46,0,5,35,6,18,606,561,45
"N00004444",328,292,3,32,1,17,0,0,0,0,0,0,36,0,3,32,1,17,328,292,36
"N00004445",405,392,0,12,1,9,0,0,0,0,0,0,13,0,0,12,1,9,405,392,13
"N00004446",448,416,1,28,3,38,3,3,0,0,0,0,32,0,1,28,3,38,445,413,32
"N00004447",359,344,1,12,2,20,3,3,0,0,0,0,15,0,1,12,2,20,356,341,15
"N00004448",489,463,2,22,2,27,1,1,0,0,0,0,26,0,2,22,2,27,488,462,26
"N00004449",439,407,4,23,4,18,12,11,1,0,1,0,32,0,4,24,4,18,427,396,31
"N00004450",388,374,0,12,2,41,0,0,0,0,0,0,14,0,0,12,2,41,388,374,14
"N00004451",637,609,1,20,5,37,6,4,2,0,2,0,28,0,1,22,5,37,631,605,26
"N00004452",298,282,0,15,1,31,1,1,0,0,0,0,16,0,0,15,1,31,297,281,16
"N00004453",322,310,0,11,1,24,5,5,0,0,0,0,12,0,0,11,1,24,317,305,12
"N00004454",300,284,0,10,0,15,6,0,6,0,6,0,16,0,0,16,0,15,294,284,10
"N00004455",309,290,0,14,5,26,0,0,0,0,0,0,19,6,0,14,5,32,309,290,19
"N00004456",298,281,3,11,3,12,3,3,0,0,0,0,17,0,3,11,3,12,295,278,17
"N00004457",300,287,0,12,1,17,0,0,0,0,0,0,13,0,0,12,1,17,300,287,13
"N00004458",311,297,0,13,1,17,1,1,0,0,0,0,14,0,0,13,1,17,310,296,14
"N00004459",861,793,10,41,16,45,26,25,1,0,0,1,68,0,10,41,17,45,835,768,67
"N00004460",243,230,0,10,3,21,2,2,0,0,0,0,13,0,0,10,3,21,241,228,13
"N00004461",395,358,11,20,5,35,4,3,1,0,0,1,37,0,11,20,6,35,391,355,36
"N00004462",299,281,0,12,6,13,1,1,0,0,0,0,18,0,0,12,6,13,298,280,18
"N00004463",461,450,0,10,1,13,4,4,0,0,0,0,11,0,0,10,1,13,457,446,11
"N00004464",374,349,0,21,0,9,7,3,4,0,1,3,25,0,0,22,3,9,367,346,21
"N00004465",490,461,1,26,2,21,7,7,0,0,0,0,29,0,1,26,2,21,483,454,29
"N00004466",413,395,0,17,1,14,13,13,0,0,0,0,18,0,0,17,1,14,400,382,18
"N00004467",426,393,2,24,7,11,7,7,0,0,0,0,33,0,2,24,7,11,419,386,33
"N00004468",506,474,5,24,3,14,5,5,0,0,0,0,32,0,5,24,3,14,501,469,32
"N00004469",378,355,0,21,1,11,1,0,1,0,0,1,23,0,0,21,2,11,377,355,22
"N00004470",299,280,2,16,1,16,0,0,0,0,0,0,19,0,2,16,1,16,299,280,19
"N00004471",394,367,0,26,1,10,0,0,0,0,0,0,27,0,0,26,1,10,394,367,27
"N00004472",751,730,3,17,0,30,1,0,1,0,0,1,21,0,3,17,1,30,750,730,20
"N00004473",365,360,0,5,0,16,0,0,0,0,0,0,5,0,0,5,0,16,365,360,5
"N00004474",865,782,6,68,3,58,14,8,6,6,0,0,83,0,12,68,3,58,851,774,77
"N00004475",267,244,1,20,2,30,0,0,0,0,0,0,23,0,1,20,2,30,267,244,23
"N00004476",266,256,2,8,0,14,0,0,0,0,0,0,10,0,2,8,0,14,266,256,10
"N00004477",316,296,2,13,5,19,8,8,0,0,0,0,20,0,2,13,5,19,308,288,20
"N00004478",562,539,2,14,5,30,2,0,2,0,0,2,23,1,2,14,7,31,560,539,21
"N00004479",536,509,0,26,1,23,5,5,0,0,0,0,27,0,0,26,1,23,531,504,27
"N00004480",471,426,0,42,3,16,3,3,0,0,0,0,45,0,0,42,3,16,468,423,45
"N00004481",565,535,0,29,1,22,0,0,0,0,0,0,30,0,0,29,1,22,565,535,30
"N00004482",300,294,1,4,1,14,0,0,0,0,0,0,6,0,1,4,1,14,300,294,6
"N00004483",373,350,1,22,0,31,4,4,0,0,0,0,23,0,1,22,0,31,369,346,23
"N00004484",611,572,4,34,1,51,0,0,0,0,0,0,39,0,4,34,1,51,611,572,39
"N00004485",409,387,10,10,2,20,1,1,0,0,0,0,22,0,10,10,2,20,408,386,22
"N00004486",333,305,3,23,1,24,3,2,1,0,1,0,28,0,3,24,1,24,330,303,27
"N00004487",447,432,1,12,2,22,5,5,0,0,0,0,15,0,1,12,2,22,442,427,15
"N00004488",446,434,3,7,2,21,1,1,0,0,0,0,12,0,3,7,2,21,445,433,12
"N00004489",347,328,1,13,5,18,0,0,0,0,0,0,19,0,1,13,5,18,347,328,19
"N00004490",511,476,0,26,7,37,3,1,2,0,2,0,35,0,0,28,7,37,508,475,33
"N00004491",376,345,5,24,0,23,3,1,2,0,2,0,31,1,5,26,0,24,373,344,29
"N00004492",332,304,2,25,1,13,0,0,0,0,0,0,28,0,2,25,1,13,332,304,28
"N00004493",411,390,2,18,1,10,1,1,0,0,0,0,21,0,2,18,1,10,410,389,21
"N00004494",300,270,5,20,5,18,1,1,0,0,0,0,30,0,5,20,5,18,299,269,30
"N00004495",339,319,5,13,2,28,1,1,0,0,0,0,20,0,5,13,2,28,338,318,20
"N00004496",906,840,6,51,9,64,5,5,0,0,0,0,66,0,6,51,9,64,901,835,66
"N00004497",380,336,0,37,7,25,3,3,0,0,0,0,44,0,0,37,7,25,377,333,44
"N00004498",1524,1407,7,100,9,77,32,31,1,0,0,1,117,1,7,100,10,78,1492,1376,116
"N00004499",197,172,0,25,0,8,0,0,0,0,0,0,25,0,0,25,0,8,197,172,25
"N00004500",172,150,0,19,2,23,1,0,1,0,0,1,22,0,0,19,3,23,171,150,21
"N00004501",444,435,0,8,1,6,1,1,0,0,0,0,9,0,0,8,1,6,443,434,9
"N00004502",328,323,2,3,0,18,0,0,0,0,0,0,5,0,2,3,0,18,328,323,5
"N00004503",411,402,0,7,2,13,0,0,0,0,0,0,9,0,0,7,2,13,411,402,9
"N00004504",265,255,0,8,2,15,2,2,0,0,0,0,10,0,0,8,2,15,263,253,10
"N00004505",413,390,0,22,0,12,1,0,1,0,1,0,23,0,0,23,0,12,412,390,22
"N00004506",362,352,0,9,1,16,7,7,0,0,0,0,10,0,0,9,1,16,355,345,10
"N00004507",285,275,5,5,0,16,0,0,0,0,0,0,10,0,5,5,0,16,285,275,10
"N00004508",671,620,9,38,3,35,2,1,1,0,1,0,51,0,9,39,3,35,669,619,50
"N00004509",275,258,1,16,0,9,0,0,0,0,0,0,17,0,1,16,0,9,275,258,17
"N00004510",322,315,0,7,0,7,1,1,0,0,0,0,7,0,0,7,0,7,321,314,7
"N00004511",225,209,0,16,0,27,1,1,0,0,0,0,16,1,0,16,0,28,224,208,16
"N00004512",412,374,0,35,3,32,3,3,0,0,0,0,38,0,0,35,3,32,409,371,38
"N00004513",434,402,0,29,3,30,2,2,0,0,0,0,32,0,0,29,3,30,432,400,32
"N00004514",617,574,5,35,3,32,5,5,0,0,0,0,43,0,5,35,3,32,612,569,43
"N00004515",395,380,0,14,0,29,3,2,1,0,0,1,15,0,0,14,1,29,392,378,14
"N00004516",391,368,0,22,0,22,1,0,1,0,1,0,23,0,0,23,0,22,390,368,22
"N00004517",410,398,0,11,0,21,1,0,1,0,1,0,12,1,0,12,0,22,409,398,11
"N00004518",286,267,1,17,1,12,0,0,0,0,0,0,19,0,1,17,1,12,286,267,19
"N00004519",340,295,0,39,5,10,4,3,1,0,1,0,45,0,0,40,5,10,336,292,44
"N00004520",1202,1099,6,73,20,56,7,3,4,0,0,4,103,1,6,73,24,57,1195,1096,99
"N00004521",334,315,0,15,4,15,6,6,0,0,0,0,19,4,0,15,4,19,328,309,19
"N00004522",337,313,0,18,6,21,0,0,0,0,0,0,24,0,0,18,6,21,337,313,24
"N00004523",378,370,2,5,1,27,1,1,0,0,0,0,8,1,2,5,1,28,377,369,8
"N00004524",253,232,0,16,5,15,1,1,0,0,0,0,21,2,0,16,5,17,252,231,21
"N00004525",388,374,0,10,4,25,4,4,0,0,0,0,14,0,0,10,4,25,384,370,14
"N00004526",420,417,0,2,1,15,1,1,0,0,0,0,3,0,0,2,1,15,419,416,3
"N00004527",338,327,5,6,0,7,2,2,0,0,0,0,11,0,5,6,0,7,336,325,11
"N00004528",478,463,1,14,0,17,1,1,0,0,0,0,15,0,1,14,0,17,477,462,15
"N00004529",292,286,0,6,0,11,0,0,0,0,0,0,6,0,0,6,0,11,292,286,6
"N00004530",357,334,3,20,0,15,3,3,0,0,0,0,23,0,3,20,0,15,354,331,23
"N00004531",403,386,4,11,2,35,2,2,0,0,0,0,17,0,4,11,2,35,401,384,17
"N00004532",399,362,0,31,6,23,9,9,0,0,0,0,37,0,0,31,6,23,390,353,37
"N00004533",304,293,2,6,3,27,1,1,0,0,0,0,11,0,2,6,3,27,303,292,11
"N00004534",1208,1138,5,57,6,85,12,10,2,0,1,1,70,2,5,58,7,87,1196,1128,68
"N00004535",839,789,0,45,5,36,3,3,0,0,0,0,50,1,0,45,5,37,836,786,50
"N00004536",290,274,0,15,1,12,0,0,0,0,0,0,16,0,0,15,1,12,290,274,16
"N00004537",222,204,1,16,1,17,0,0,0,0,0,0,18,0,1,16,1,17,222,204,18
