"Geography_Code","NM_1521_1_0","NM_1521_1_1","NM_1521_1_10","NM_1521_1_11","NM_1521_1_12","NM_1521_1_13","NM_1521_1_2","NM_1521_1_3","NM_1521_1_4","NM_1521_1_5","NM_1521_1_6","NM_1521_1_7","NM_1521_1_8","NM_1521_1_9"
"N00000001",754,57,18,9,9,26,30,27,274,197,18,48,73,43
"N00000002",249,35,14,9,5,17,6,29,69,27,18,21,21,27
"N00000003",166,16,8,6,2,13,2,14,48,22,23,4,15,17
"N00000004",449,27,15,8,7,51,5,22,90,48,88,27,58,45
"N00000005",275,30,3,3,0,20,8,22,69,30,55,16,30,22
"N00000006",174,21,8,6,2,13,4,17,32,27,28,12,27,6
"N00000007",176,17,6,2,4,13,5,12,38,29,22,14,22,15
"N00000008",229,25,8,5,3,14,6,19,54,33,28,16,22,29
"N00000009",533,70,17,9,8,36,12,58,157,76,57,26,65,29
"N00000010",172,12,8,5,3,17,2,10,26,23,32,12,21,21
"N00000011",214,9,10,7,3,14,1,8,35,28,7,21,41,49
"N00000012",207,4,7,6,1,9,2,2,31,27,10,31,49,39
"N00000013",197,12,15,6,9,11,2,10,29,33,12,20,32,33
"N00000014",359,18,16,11,5,20,2,16,62,43,26,42,78,54
"N00000015",170,0,13,8,5,10,0,0,26,18,9,21,28,45
"N00000016",172,4,9,2,7,7,0,4,26,28,11,15,34,38
"N00000017",244,12,16,9,7,13,4,8,29,33,14,24,55,48
"N00000018",165,8,3,0,3,16,1,7,31,21,5,17,27,37
"N00000019",201,4,13,10,3,9,0,4,17,24,9,26,42,57
"N00000020",158,0,12,7,5,1,0,0,25,26,2,16,34,42
"N00000021",198,12,8,4,4,8,4,8,29,27,10,19,43,42
"N00000022",191,3,12,9,3,16,0,3,24,25,12,9,47,43
"N00000023",160,4,8,6,2,5,0,4,16,14,5,31,38,39
"N00000024",379,43,10,4,6,45,9,34,93,45,62,25,36,20
"N00000025",347,29,14,10,4,27,7,22,81,35,58,25,36,42
"N00000026",356,30,8,7,1,44,5,25,88,50,61,21,25,29
"N00000027",380,24,21,17,4,33,3,21,77,61,65,21,46,32
"N00000028",184,7,8,2,6,26,3,4,36,29,16,10,24,28
"N00000029",304,37,3,0,3,32,7,30,54,49,55,24,28,22
"N00000030",277,16,8,5,3,24,5,11,67,39,49,15,37,22
"N00000031",489,47,26,16,10,51,11,36,112,48,85,28,49,43
"N00000032",270,21,7,4,3,25,5,16,56,39,41,20,32,29
"N00000033",361,30,6,5,1,30,2,28,71,44,65,28,49,38
"N00000034",322,27,16,12,4,24,4,23,76,38,34,29,44,34
"N00000035",222,9,20,10,10,13,2,7,29,26,15,23,40,47
"N00000036",260,23,15,10,5,26,6,17,53,35,23,9,33,43
"N00000037",212,9,18,11,7,14,1,8,43,37,14,17,30,30
"N00000038",284,18,15,10,5,34,6,12,60,29,39,24,42,23
"N00000039",826,42,32,14,18,100,12,30,173,124,71,61,139,84
"N00000040",201,3,10,7,3,16,0,3,20,34,18,14,37,49
"N00000041",314,24,11,9,2,36,8,16,71,56,24,24,38,30
"N00000042",307,16,13,8,5,39,3,13,59,42,35,31,38,34
"N00000043",787,56,50,35,15,92,18,38,182,108,50,48,119,82
"N00000044",202,3,14,12,2,25,0,3,31,35,13,9,47,25
"N00000045",367,38,8,3,5,26,10,28,77,43,66,28,38,43
"N00000046",282,18,20,17,3,23,1,17,59,34,54,12,35,27
"N00000047",285,20,22,21,1,18,2,18,65,46,42,18,29,25
"N00000048",224,6,13,7,6,17,3,3,18,22,18,20,50,60
"N00000049",202,7,14,9,5,8,1,6,27,25,15,18,44,44
"N00000050",232,22,6,5,1,13,6,16,51,29,24,20,26,41
"N00000051",219,3,27,18,9,13,1,2,26,20,9,19,38,64
"N00000052",231,7,21,11,10,18,2,5,43,29,17,18,32,46
"N00000053",196,4,15,10,5,18,1,3,27,18,8,18,46,42
"N00000054",193,4,16,11,5,9,2,2,33,29,7,22,34,39
"N00000055",204,1,9,4,5,16,0,1,32,28,9,22,47,40
"N00000056",219,5,19,11,8,8,1,4,23,25,9,25,49,56
"N00000057",192,4,17,11,6,15,2,2,13,20,6,12,58,47
"N00000058",191,5,17,13,4,12,0,5,23,29,5,12,52,36
"N00000059",170,4,13,10,3,9,1,3,16,18,6,14,51,39
"N00000060",284,5,20,13,7,13,1,4,38,34,13,20,72,69
"N00000061",210,23,3,3,0,16,3,20,52,23,18,20,27,28
"N00000062",272,36,12,9,3,25,7,29,78,39,15,16,33,18
"N00000063",276,14,22,14,8,27,1,13,42,19,16,32,51,53
"N00000064",206,3,33,23,10,12,1,2,23,11,13,25,45,41
"N00000065",310,25,11,8,3,23,9,16,68,48,21,22,44,48
"N00000066",211,18,3,2,1,10,6,12,58,41,13,18,20,30
"N00000067",234,3,25,18,7,19,1,2,21,25,17,24,54,46
"N00000068",272,30,4,4,0,28,7,23,63,35,27,26,32,27
"N00000069",228,2,42,30,12,19,1,1,16,24,10,22,45,48
"N00000070",184,20,4,2,2,14,11,9,51,35,12,13,19,16
"N00000071",206,4,10,7,3,8,1,3,41,38,14,21,36,34
"N00000072",1244,93,40,25,15,87,14,79,287,190,93,83,201,170
"N00000073",361,10,22,16,6,9,2,8,73,42,27,28,62,88
"N00000074",756,79,16,8,8,43,13,66,205,137,54,60,89,73
"N00000075",329,19,32,30,2,21,12,7,63,84,12,23,41,34
"N00000076",233,13,2,1,1,27,5,8,65,34,14,21,32,25
"N00000077",200,10,3,2,1,18,1,9,39,39,15,20,27,29
"N00000078",321,35,6,4,2,26,8,27,83,43,21,27,58,22
"N00000079",399,50,7,5,2,50,13,37,111,53,61,22,27,18
"N00000080",309,48,3,2,1,26,9,39,73,68,27,16,29,19
"N00000081",254,32,7,5,2,23,11,21,71,29,23,16,26,27
"N00000082",257,28,5,4,1,15,5,23,68,37,50,14,23,17
"N00000083",484,50,14,9,5,57,12,38,105,66,82,28,47,35
"N00000084",334,34,11,10,1,31,8,26,82,48,54,16,31,27
"N00000085",300,19,22,16,6,18,3,16,40,39,15,18,56,73
"N00000086",279,14,14,8,6,27,3,11,59,38,31,17,39,40
"N00000087",651,85,22,14,8,57,17,68,141,83,75,51,70,67
"N00000088",154,1,9,2,7,7,0,1,24,19,8,14,31,41
"N00000089",334,31,10,7,3,32,9,22,75,52,32,20,46,36
"N00000090",283,14,7,4,3,24,3,11,71,36,26,17,47,41
"N00000091",338,35,16,9,7,18,13,22,72,35,45,24,39,54
"N00000092",337,36,16,11,5,23,8,28,82,42,43,17,44,34
"N00000093",289,18,13,6,7,30,4,14,55,39,43,17,44,30
"N00000094",353,43,13,9,4,29,5,38,98,37,55,21,34,23
"N00000095",329,26,13,6,7,37,6,20,69,45,52,19,39,29
"N00000096",370,43,31,29,2,30,14,29,85,46,53,22,36,24
"N00000097",606,30,20,7,13,49,4,26,131,89,49,56,95,87
"N00000098",890,72,24,20,4,56,9,63,238,141,44,62,129,124
"N00000099",180,6,17,14,3,10,1,5,30,17,11,11,40,38
"N00000100",254,4,14,8,6,14,0,4,55,32,15,27,46,47
"N00000101",193,3,19,11,8,17,0,3,27,24,5,17,38,43
"N00000102",244,12,14,7,7,27,1,11,64,38,10,17,29,33
"N00000103",430,16,47,38,9,27,3,13,62,49,18,39,79,93
"N00000104",231,9,19,15,4,12,2,7,32,36,12,17,37,57
"N00000105",258,2,15,13,2,16,0,2,29,24,10,24,67,71
"N00000106",139,1,14,7,7,8,1,0,13,15,7,9,35,37
"N00000107",190,3,23,13,10,14,0,3,22,13,9,16,43,47
"N00000108",169,12,4,2,2,11,2,10,33,23,7,20,28,31
"N00000109",385,15,12,6,6,15,3,12,46,53,18,40,84,102
"N00000110",210,4,7,5,2,21,2,2,22,25,12,28,51,40
"N00000111",266,28,10,3,7,18,6,22,62,39,24,22,32,31
"N00000112",299,17,16,11,5,33,9,8,49,29,17,35,44,59
"N00000113",230,11,14,8,6,10,2,9,47,28,16,22,41,41
"N00000114",255,12,11,8,3,14,2,10,59,38,15,25,38,43
"N00000115",224,2,24,18,6,24,2,0,27,29,10,13,50,45
"N00000116",220,8,14,7,7,11,3,5,24,36,15,24,52,36
"N00000117",120,2,18,9,9,6,0,2,8,7,1,10,34,34
"N00000118",256,34,20,20,0,18,8,26,80,28,23,8,29,16
"N00000119",221,33,8,4,4,19,7,26,64,34,23,8,22,10
"N00000120",237,32,6,5,1,24,10,22,58,37,33,12,20,15
"N00000121",230,17,11,6,5,16,5,12,50,40,21,15,28,32
"N00000122",363,53,6,4,2,24,16,37,108,42,61,15,39,15
"N00000123",255,55,6,5,1,22,14,41,95,28,22,3,16,8
"N00000124",259,35,12,12,0,12,8,27,81,31,32,17,28,11
"N00000125",322,27,20,15,5,35,5,22,54,40,58,17,39,32
"N00000126",322,19,19,17,2,46,5,14,49,26,52,23,41,47
"N00000127",264,7,16,13,3,19,0,7,44,32,42,24,43,37
"N00000128",738,41,73,59,14,78,10,31,140,67,108,46,80,105
"N00000129",242,2,37,31,6,18,0,2,21,14,22,18,52,58
"N00000130",340,28,11,6,5,40,10,18,88,56,28,24,40,25
"N00000131",303,34,5,5,0,25,10,24,70,53,36,14,37,29
"N00000132",264,15,10,5,5,21,1,14,59,40,58,18,26,17
"N00000133",236,15,11,7,4,14,5,10,45,35,26,21,34,35
"N00000134",332,25,9,6,3,22,11,14,77,69,43,16,44,27
"N00000135",225,7,19,10,9,18,3,4,20,34,21,16,47,43
"N00000136",386,33,5,4,1,29,5,28,82,86,43,33,43,32
"N00000137",225,14,6,4,2,20,5,9,44,48,18,20,31,24
"N00000138",339,37,4,1,3,38,6,31,80,68,36,22,39,15
"N00000139",227,14,16,9,7,15,6,8,47,40,25,17,28,25
"N00000140",266,17,23,8,15,17,2,15,47,36,29,14,51,32
"N00000141",293,7,17,10,7,21,2,5,32,46,17,23,71,59
"N00000142",143,6,11,6,5,11,1,5,18,16,14,15,29,23
"N00000143",160,5,9,4,5,6,2,3,14,17,9,16,44,40
"N00000144",176,5,17,6,11,13,0,5,22,21,11,10,39,38
"N00000145",80,1,7,6,1,6,1,0,6,6,4,6,23,21
"N00000146",206,28,8,4,4,21,8,20,45,22,31,9,30,12
"N00000147",160,5,11,5,6,15,1,4,23,26,5,19,32,24
"N00000148",475,20,41,24,17,22,1,19,56,78,44,51,90,73
"N00000149",298,18,12,7,5,15,3,15,53,52,29,29,60,30
"N00000150",260,20,10,7,3,13,5,15,71,47,24,22,34,19
"N00000151",217,9,24,17,7,10,4,5,30,27,12,22,47,36
"N00000152",210,2,20,14,6,14,1,1,20,22,15,24,54,39
"N00000153",167,2,8,4,4,9,0,2,11,29,16,26,33,33
"N00000154",196,11,11,10,1,14,4,7,30,33,23,19,33,22
"N00000155",261,17,12,9,3,17,4,13,49,34,41,21,45,25
"N00000156",209,14,3,2,1,12,3,11,52,34,21,22,31,20
"N00000157",279,32,5,2,3,20,3,29,65,32,57,13,39,16
"N00000158",508,28,21,11,10,32,10,18,104,83,57,36,94,53
"N00000159",171,5,16,11,5,9,1,4,33,27,11,11,25,34
"N00000160",233,28,11,7,4,16,5,23,52,40,12,15,33,26
"N00000161",267,43,5,3,2,33,11,32,82,45,26,7,22,4
"N00000162",199,11,6,3,3,11,4,7,34,33,24,22,30,28
"N00000163",240,4,21,11,10,17,3,1,33,40,19,24,40,42
"N00000164",194,30,3,3,0,10,7,23,52,25,35,9,21,9
"N00000165",234,40,8,5,3,17,8,32,57,29,39,10,20,14
"N00000166",217,22,8,4,4,11,3,19,46,47,15,21,33,14
"N00000167",276,26,4,1,3,26,4,22,65,60,26,19,27,23
"N00000168",256,33,4,2,2,10,5,28,65,36,28,21,38,21
"N00000169",546,63,18,15,3,36,10,53,101,87,107,29,60,45
"N00000170",262,10,14,7,7,12,3,7,51,35,35,24,47,34
"N00000171",313,20,8,4,4,25,4,16,86,49,56,14,35,20
"N00000172",595,53,24,15,9,34,9,44,124,93,115,38,75,39
"N00000173",286,24,7,5,2,13,7,17,68,48,66,17,27,16
"N00000174",278,14,17,12,5,22,4,10,36,30,22,21,50,66
"N00000175",279,20,6,5,1,14,4,16,67,34,34,18,45,41
"N00000176",368,9,15,8,7,27,2,7,43,57,25,38,81,73
"N00000177",247,10,12,3,9,17,2,8,32,25,26,25,57,43
"N00000178",475,21,40,30,10,41,7,14,59,60,26,28,106,94
"N00000179",632,19,49,35,14,27,5,14,114,103,42,45,119,114
"N00000180",203,1,25,17,8,11,1,0,20,22,6,23,48,47
"N00000181",238,7,11,2,9,10,1,6,48,21,21,19,43,58
"N00000182",153,6,5,4,1,6,1,5,22,35,12,16,30,21
"N00000183",231,25,17,8,9,12,3,22,54,46,21,13,26,17
"N00000184",241,18,10,4,6,14,6,12,60,36,19,27,34,23
"N00000185",151,8,7,1,6,9,1,7,37,18,13,13,25,21
"N00000186",196,14,6,4,2,16,1,13,32,27,15,21,37,28
"N00000187",178,5,15,9,6,9,1,4,13,27,15,16,42,36
"N00000188",249,9,16,10,6,19,1,8,29,34,23,21,47,51
"N00000189",248,18,6,3,3,25,6,12,61,52,40,11,24,11
"N00000190",245,20,8,5,3,11,4,16,53,46,21,18,45,23
"N00000191",244,22,7,5,2,21,5,17,43,44,19,23,39,26
"N00000192",244,5,10,8,2,20,1,4,31,45,20,19,44,50
"N00000193",196,8,15,8,7,21,1,7,20,29,10,19,39,35
"N00000194",183,2,9,5,4,5,0,2,34,29,18,18,34,34
"N00000195",160,4,13,8,5,3,1,3,15,27,12,14,36,36
"N00000196",169,4,14,14,0,12,2,2,16,14,10,14,32,53
"N00000197",247,12,2,1,1,15,2,10,55,47,12,25,46,33
"N00000198",228,14,7,5,2,16,1,13,53,38,27,17,29,27
"N00000199",265,17,8,6,2,17,4,13,64,55,15,18,44,27
"N00000200",246,17,6,4,2,12,6,11,55,42,29,16,43,26
"N00000201",228,24,8,4,4,10,2,22,66,33,33,13,26,15
"N00000202",250,29,5,4,1,13,6,23,70,56,20,13,27,17
"N00000203",243,29,7,4,3,16,5,24,47,25,49,16,32,22
"N00000204",280,18,8,6,2,17,5,13,56,50,19,35,46,31
"N00000205",225,21,10,4,6,16,6,15,57,40,19,16,24,22
"N00000206",315,31,11,6,5,9,11,20,73,60,20,18,47,46
"N00000207",215,18,6,2,4,16,2,16,49,30,16,18,36,26
"N00000208",252,16,5,4,1,30,5,11,75,54,15,19,28,10
"N00000209",285,39,2,1,1,36,7,32,77,54,22,15,28,12
"N00000210",291,17,12,7,5,11,4,13,61,35,24,33,49,49
"N00000211",369,27,19,11,8,16,5,22,77,49,35,20,70,56
"N00000212",132,7,11,5,6,9,2,5,22,18,11,13,25,16
"N00000213",222,24,12,6,6,12,5,19,59,33,15,15,32,20
"N00000214",233,22,7,4,3,11,5,17,59,40,24,18,36,16
"N00000215",310,32,9,3,6,29,6,26,89,43,62,10,23,13
"N00000216",312,26,15,11,4,19,4,22,71,44,60,16,52,9
"N00000217",350,58,5,5,0,30,14,44,120,50,44,3,31,9
"N00000218",246,36,2,0,2,17,8,28,74,50,26,8,21,12
"N00000219",183,1,18,8,10,7,0,1,17,18,15,13,49,45
"N00000220",209,3,22,13,9,16,1,2,15,18,10,11,62,52
"N00000221",194,3,13,7,6,8,1,2,24,20,10,26,51,39
"N00000222",202,11,8,4,4,9,1,10,42,36,28,16,30,22
"N00000223",235,11,8,5,3,27,5,6,57,31,19,16,42,24
"N00000224",188,12,14,7,7,17,4,8,40,25,15,15,29,21
"N00000225",95,9,3,3,0,5,2,7,15,15,13,8,18,9
"N00000226",197,16,7,6,1,17,6,10,49,36,26,11,22,13
"N00000227",149,6,5,2,3,6,3,3,21,26,15,19,24,27
"N00000228",228,10,3,2,1,13,4,6,49,37,21,21,49,25
"N00000229",272,20,10,8,2,27,5,15,67,44,18,19,40,27
"N00000230",211,3,15,8,7,14,1,2,28,29,7,25,53,37
"N00000231",205,2,24,13,11,21,0,2,13,13,9,18,53,52
"N00000232",236,8,20,12,8,23,1,7,31,28,14,21,48,43
"N00000233",199,9,12,8,4,9,2,7,34,32,9,23,28,43
"N00000234",192,12,17,10,7,4,1,11,24,24,8,22,51,30
"N00000235",240,23,13,6,7,20,3,20,55,32,15,10,45,27
"N00000236",204,12,16,8,8,17,2,10,34,24,16,9,43,33
"N00000237",301,53,4,2,2,27,10,43,84,39,43,16,17,18
"N00000238",237,35,3,3,0,16,10,25,86,39,23,6,25,4
"N00000239",186,4,13,10,3,12,0,4,21,19,11,17,51,38
"N00000240",240,4,13,6,7,32,2,2,32,29,14,24,51,41
"N00000241",316,52,5,4,1,44,13,39,100,49,22,7,26,11
"N00000242",273,36,5,2,3,33,11,25,77,42,28,21,22,9
"N00000243",197,8,6,3,3,15,3,5,36,23,19,19,33,38
"N00000244",200,4,27,18,9,10,3,1,20,27,9,13,39,51
"N00000245",243,10,9,7,2,10,2,8,49,39,15,26,50,35
"N00000246",226,4,20,14,6,16,2,2,29,32,9,11,50,55
"N00000247",241,15,9,6,3,18,4,11,55,36,40,19,31,18
"N00000248",266,23,6,5,1,17,3,20,64,51,27,12,42,24
"N00000249",280,23,4,2,2,22,2,21,57,50,24,33,50,17
"N00000250",298,21,8,2,6,22,8,13,69,63,21,27,47,20
"N00000251",311,27,7,3,4,31,5,22,80,55,32,15,48,16
"N00000252",249,44,4,3,1,28,7,37,64,29,37,14,11,18
"N00000253",380,31,15,12,3,32,7,24,82,52,78,17,47,26
"N00000254",238,41,7,3,4,21,7,34,51,40,35,12,16,15
"N00000255",260,31,10,7,3,17,3,28,63,37,53,9,31,9
"N00000256",576,111,9,7,2,45,22,89,157,80,71,26,49,28
"N00000257",313,14,14,6,8,26,1,13,78,50,22,28,42,39
"N00000258",267,42,3,3,0,26,11,31,81,39,37,14,13,12
"N00000259",358,24,15,10,5,29,7,17,76,54,69,16,34,41
"N00000260",390,19,19,12,7,22,1,18,92,62,69,26,46,35
"N00000261",398,36,15,7,8,32,3,33,75,57,104,14,37,28
"N00000262",284,22,13,8,5,18,2,20,47,54,53,14,38,25
"N00000263",182,5,14,5,9,13,2,3,28,18,30,19,23,32
"N00000264",400,21,23,18,5,44,1,20,53,66,57,18,62,56
"N00000265",273,5,23,11,12,28,1,4,18,45,22,13,56,63
"N00000266",242,12,12,5,7,27,4,8,55,35,30,20,23,28
"N00000267",330,54,2,0,2,40,14,40,101,55,31,8,25,14
"N00000268",303,28,4,3,1,27,4,24,80,51,39,21,30,23
"N00000269",264,29,5,3,2,25,7,22,61,43,47,11,24,19
"N00000270",274,29,9,7,2,16,6,23,39,42,53,21,38,27
"N00000271",275,30,10,9,1,24,2,28,67,47,45,19,16,17
"N00000272",213,15,5,3,2,6,2,13,41,33,35,19,35,24
"N00000273",321,66,5,3,2,32,15,51,82,48,39,10,26,13
"N00000274",348,32,4,3,1,20,10,22,102,46,60,22,30,32
"N00000275",225,7,5,4,1,16,2,5,43,36,24,24,37,33
"N00000276",230,9,4,3,1,15,2,7,45,40,19,16,49,33
"N00000277",225,16,1,1,0,19,4,12,50,35,20,31,36,17
"N00000278",221,3,6,2,4,14,1,2,33,53,30,17,41,24
"N00000279",134,9,5,1,4,2,3,6,39,20,6,16,21,16
"N00000280",251,7,23,13,10,19,2,5,33,33,20,14,63,39
"N00000281",254,21,7,6,1,18,9,12,71,28,56,13,27,13
"N00000282",269,21,8,6,2,20,6,15,57,37,50,15,37,24
"N00000283",254,15,6,2,4,12,4,11,66,55,29,18,37,16
"N00000284",260,15,17,11,6,25,0,15,42,44,22,20,45,30
"N00000285",209,1,24,13,11,15,0,1,23,26,14,11,52,43
"N00000286",206,15,16,9,7,8,3,12,40,22,29,17,34,25
"N00000287",209,6,20,9,11,8,1,5,20,19,22,16,65,33
"N00000288",262,20,13,7,6,16,7,13,50,46,22,22,44,29
"N00000289",353,13,13,10,3,24,1,12,66,72,32,32,60,41
"N00000290",193,6,10,7,3,10,2,4,22,17,11,23,48,46
"N00000291",393,30,14,11,3,22,6,24,69,64,47,45,63,39
"N00000292",490,43,10,6,4,30,14,29,127,83,78,33,57,29
"N00000293",346,35,6,4,2,27,8,27,112,79,26,13,34,14
"N00000294",300,22,8,7,1,21,2,20,72,45,75,13,22,22
"N00000295",263,31,5,3,2,19,7,24,70,45,33,10,32,18
"N00000296",221,18,7,5,2,19,3,15,46,38,19,19,35,20
"N00000297",257,17,6,5,1,15,4,13,45,48,26,33,43,24
"N00000298",254,5,8,7,1,20,1,4,48,50,15,18,57,33
"N00000299",235,16,13,7,6,13,4,12,43,51,16,26,37,20
"N00000300",207,7,17,13,4,11,3,4,33,35,6,16,47,35
"N00000301",254,25,3,3,0,19,6,19,74,45,21,19,29,19
"N00000302",273,17,5,3,2,32,3,14,62,55,25,21,41,15
"N00000303",228,15,4,2,2,20,3,12,54,47,21,22,33,12
"N00000304",238,16,7,3,4,14,3,13,49,47,19,21,41,24
"N00000305",296,27,7,5,2,32,5,22,87,66,22,16,29,10
"N00000306",261,25,9,5,4,19,5,20,64,46,16,23,34,25
"N00000307",264,19,6,2,4,28,1,18,46,51,21,26,47,20
"N00000308",223,8,2,2,0,20,3,5,48,44,20,18,39,24
"N00000309",280,25,7,4,3,34,5,20,60,55,16,23,38,22
"N00000310",310,23,11,9,2,20,0,23,69,36,78,15,32,26
"N00000311",248,13,17,11,6,15,1,12,51,28,39,16,24,45
"N00000312",385,19,25,15,10,32,2,17,75,51,72,21,44,46
"N00000313",420,25,18,10,8,36,5,20,75,64,85,22,48,47
"N00000314",283,9,22,10,12,27,2,7,39,42,22,17,39,66
"N00000315",258,12,32,21,11,26,3,9,26,20,34,20,45,43
"N00000316",254,11,13,10,3,23,2,9,35,39,34,19,40,40
"N00000317",337,21,33,20,13,26,4,17,50,51,40,14,43,59
"N00000318",261,14,15,10,5,22,6,8,43,46,42,15,35,29
"N00000319",572,25,29,24,5,40,5,20,79,90,84,46,115,64
"N00000320",226,4,13,9,4,12,0,4,30,31,48,17,44,27
"N00000321",389,12,31,19,12,25,2,10,54,56,55,32,79,45
"N00000322",280,9,24,17,7,13,2,7,44,38,37,11,60,44
"N00000323",360,30,8,4,4,24,5,25,70,58,63,24,49,34
"N00000324",296,28,8,5,3,26,2,26,62,47,48,20,34,23
"N00000325",365,23,21,14,7,30,3,20,81,51,44,26,52,37
"N00000326",671,42,24,16,8,44,8,34,139,84,80,63,102,93
"N00000327",235,7,18,11,7,15,0,7,24,29,15,26,46,55
"N00000328",199,6,22,10,12,10,2,4,21,21,8,21,48,42
"N00000329",293,6,32,24,8,21,3,3,36,38,17,25,65,53
"N00000330",388,54,9,6,3,24,14,40,91,77,41,20,40,32
"N00000331",431,24,30,17,13,28,5,19,78,52,41,37,80,61
"N00000332",193,3,23,14,9,6,2,1,17,21,7,10,71,35
"N00000333",195,1,28,14,14,17,1,0,14,22,8,16,48,41
"N00000334",212,4,31,17,14,19,3,1,23,21,7,17,59,31
"N00000335",248,12,9,6,3,11,2,10,55,54,16,15,50,26
"N00000336",256,16,5,1,4,16,4,12,65,50,22,16,49,17
"N00000337",229,30,3,1,2,17,7,23,63,38,23,17,22,16
"N00000338",224,20,2,2,0,21,1,19,56,35,26,15,34,15
"N00000339",224,18,5,5,0,16,4,14,57,44,20,17,32,15
"N00000340",310,27,9,7,2,26,9,18,65,48,42,22,44,27
"N00000341",275,18,3,2,1,23,4,14,80,61,15,22,35,18
"N00000342",288,23,6,3,3,35,5,18,69,61,18,20,37,19
"N00000343",263,24,8,4,4,20,6,18,57,49,28,15,43,19
"N00000344",331,4,106,98,8,24,0,4,21,28,18,21,44,65
"N00000345",308,3,59,42,17,23,1,2,24,20,27,17,72,63
"N00000346",447,23,32,19,13,54,6,17,78,61,48,22,64,65
"N00000347",205,6,21,15,6,9,1,5,27,19,14,11,46,52
"N00000348",296,19,37,29,8,37,5,14,60,28,30,13,36,36
"N00000349",277,11,19,14,5,27,2,9,66,37,35,16,31,35
"N00000350",399,28,33,21,12,36,5,23,64,55,58,19,42,64
"N00000351",306,14,19,12,7,35,2,12,52,35,57,18,42,34
"N00000352",346,22,16,9,7,46,5,17,71,33,63,15,34,46
"N00000353",311,20,20,16,4,32,6,14,52,33,58,15,43,38
"N00000354",286,18,8,5,3,35,4,14,58,32,59,18,32,26
"N00000355",323,17,23,15,8,28,0,17,53,42,59,23,38,40
"N00000356",283,6,54,37,17,37,1,5,32,28,10,18,42,56
"N00000357",814,18,102,73,29,73,3,15,92,100,78,60,129,162
"N00000358",264,4,45,33,12,31,1,3,21,27,14,16,54,52
"N00000359",628,19,87,53,34,31,3,16,76,67,37,49,121,141
"N00000360",311,8,19,11,8,47,2,6,57,25,56,19,40,40
"N00000361",269,21,19,13,6,18,6,15,34,19,41,22,46,49
"N00000362",277,14,12,6,6,34,0,14,36,31,51,23,29,47
"N00000363",342,14,17,10,7,33,2,12,62,34,71,16,35,60
"N00000364",329,10,17,8,9,39,1,9,54,31,75,24,40,39
"N00000365",171,1,23,19,4,15,0,1,20,22,23,13,28,26
"N00000366",369,14,30,17,13,29,2,12,60,33,51,31,50,71
"N00000367",245,10,25,17,8,15,1,9,29,16,20,19,61,50
"N00000368",380,23,35,27,8,36,8,15,49,49,60,23,47,58
"N00000369",284,16,4,3,1,32,3,13,49,32,45,30,34,42
"N00000370",344,23,17,10,7,40,3,20,61,35,50,28,43,47
"N00000371",313,27,13,9,4,37,7,20,60,21,57,19,42,37
"N00000372",264,17,14,8,6,16,4,13,65,34,32,13,48,25
"N00000373",332,37,14,7,7,33,15,22,87,51,27,19,36,28
"N00000374",268,38,13,5,8,22,9,29,82,29,21,15,32,16
"N00000375",217,26,7,3,4,15,8,18,56,28,29,11,21,24
"N00000376",190,11,12,2,10,10,4,7,38,35,16,11,30,27
"N00000377",188,15,10,7,3,9,4,11,55,26,11,10,22,30
"N00000378",210,3,41,34,7,24,2,1,21,25,13,9,46,28
"N00000379",334,27,9,4,5,28,10,17,87,39,28,27,38,51
"N00000380",397,15,42,31,11,36,1,14,58,52,65,23,50,56
"N00000381",665,21,80,60,20,70,5,16,98,75,72,48,91,110
"N00000382",400,19,33,26,7,38,0,19,74,51,64,25,49,47
"N00000383",310,15,24,13,11,37,2,13,38,31,66,23,36,40
"N00000384",346,21,32,23,9,45,6,15,56,32,59,17,39,45
"N00000385",299,17,17,12,5,31,3,14,55,30,65,20,30,34
"N00000386",221,7,29,16,13,25,0,7,30,15,13,17,41,44
"N00000387",156,6,23,15,8,15,0,6,16,18,12,13,29,24
"N00000388",1105,40,147,97,50,109,9,31,195,128,83,65,147,191
"N00000389",301,33,14,10,4,26,6,27,67,37,35,12,34,43
"N00000390",711,57,17,10,7,72,12,45,145,90,133,58,81,58
"N00000391",380,34,17,11,6,27,7,27,72,50,80,26,37,37
"N00000392",1062,77,48,37,11,84,15,62,201,149,122,81,153,147
"N00000393",337,25,10,7,3,13,12,13,64,55,52,26,46,46
"N00000394",306,34,10,4,6,28,6,28,75,30,56,22,30,21
"N00000395",344,34,25,18,7,35,3,31,61,34,70,21,35,29
"N00000396",281,23,6,5,1,24,6,17,66,31,50,15,34,32
"N00000397",391,37,20,11,9,30,7,30,109,43,53,19,45,35
"N00000398",326,27,6,4,2,31,13,14,71,48,48,24,41,30
"N00000399",241,9,7,4,3,21,1,8,42,32,13,19,54,44
"N00000400",188,7,27,16,11,12,2,5,19,15,26,15,27,40
"N00000401",219,10,33,22,11,16,1,9,24,23,26,15,32,40
"N00000402",195,5,23,18,5,14,1,4,26,18,18,17,31,43
"N00000403",359,15,40,24,16,30,3,12,65,44,34,20,50,61
"N00000404",204,3,29,20,9,9,0,3,22,7,19,13,42,60
"N00000405",169,2,32,22,10,17,0,2,17,15,13,15,25,33
"N00000406",279,15,10,6,4,28,6,9,52,34,49,16,39,36
"N00000407",795,36,66,42,24,84,7,29,132,93,134,52,93,105
"N00000408",325,19,7,6,1,50,3,16,45,42,65,18,34,45
"N00000409",280,21,13,11,2,16,2,19,48,37,28,26,44,47
"N00000410",286,27,5,4,1,28,4,23,51,36,66,18,33,22
"N00000411",258,14,17,13,4,28,4,10,40,23,33,16,45,42
"N00000412",317,20,20,14,6,32,5,15,46,39,51,25,44,40
"N00000413",320,11,30,21,9,29,3,8,57,32,51,24,44,42
"N00000414",274,13,18,11,7,33,2,11,45,22,48,21,43,31
"N00000415",326,17,13,7,6,30,3,14,58,36,37,23,49,63
"N00000416",289,20,13,8,5,25,4,16,60,35,62,17,20,37
"N00000417",376,22,6,3,3,26,4,18,88,50,37,34,63,50
"N00000418",601,54,27,18,9,39,8,46,128,85,73,39,86,70
"N00000419",264,20,5,4,1,14,3,17,72,37,42,19,26,29
"N00000420",242,31,12,8,4,17,4,27,43,34,24,22,31,28
"N00000421",371,18,7,5,2,31,7,11,80,73,52,18,56,36
"N00000422",306,5,17,10,7,24,2,3,39,48,20,31,57,65
"N00000423",312,28,8,7,1,28,7,21,53,42,53,26,37,37
"N00000424",402,22,17,8,9,31,3,19,78,48,39,34,67,66
"N00000425",259,19,13,11,2,29,6,13,55,39,29,13,25,37
"N00000426",230,15,17,14,3,16,1,14,44,14,21,24,36,43
"N00000427",246,10,17,15,2,28,3,7,39,29,26,30,35,32
"N00000428",294,16,17,11,6,26,3,13,54,29,31,27,43,51
"N00000429",322,23,12,8,4,39,3,20,79,39,45,15,32,38
"N00000430",347,20,11,9,2,36,8,12,60,47,65,23,46,39
"N00000431",256,15,15,8,7,35,3,12,34,29,30,18,42,38
"N00000432",192,9,11,7,4,14,2,7,31,16,18,17,40,36
"N00000433",203,6,33,30,3,10,2,4,27,13,13,31,35,35
"N00000434",302,12,15,11,4,24,1,11,31,35,20,26,80,59
"N00000435",293,10,33,19,14,17,2,8,45,30,20,27,67,44
"N00000436",371,22,11,9,2,41,6,16,66,64,58,24,50,35
"N00000437",473,42,10,5,5,52,11,31,100,60,81,22,52,54
"N00000438",366,42,11,5,6,43,5,37,73,42,57,23,27,48
"N00000439",312,23,15,8,7,32,5,18,62,40,58,21,32,29
"N00000440",304,10,31,18,13,32,4,6,34,28,65,19,43,42
"N00000441",237,14,17,9,8,18,3,11,47,24,37,14,23,43
"N00000442",309,19,24,18,6,25,2,17,60,37,38,24,48,34
"N00000443",346,41,7,4,3,33,10,31,107,50,48,13,26,21
"N00000444",422,24,33,21,12,29,4,20,78,44,30,40,74,70
"N00000445",287,48,4,2,2,37,12,36,91,40,21,7,26,13
"N00000446",257,34,11,7,4,20,4,30,68,36,21,18,29,20
"N00000447",203,24,9,5,4,15,5,19,46,33,22,14,21,19
"N00000448",197,5,24,18,6,12,2,3,23,26,7,12,30,58
"N00000449",306,18,5,3,2,29,2,16,65,33,75,24,30,27
"N00000450",333,23,14,8,6,15,5,18,83,39,50,29,47,33
"N00000451",344,27,21,15,6,29,5,22,87,43,36,21,42,38
"N00000452",308,18,14,11,3,37,4,14,69,27,59,14,37,33
"N00000453",248,7,26,18,8,22,4,3,28,28,29,13,39,56
"N00000454",371,30,10,7,3,32,10,20,61,51,72,28,54,33
"N00000455",187,9,12,4,8,8,4,5,36,17,18,12,46,29
"N00000456",226,29,3,2,1,20,9,20,76,35,16,11,24,12
"N00000457",254,7,3,1,2,22,3,4,59,41,17,32,48,25
"N00000458",267,25,8,3,5,26,9,16,78,37,31,13,30,19
"N00000459",530,36,56,48,8,48,11,25,91,93,35,35,81,55
"N00000460",266,13,10,7,3,14,3,10,44,39,17,20,55,54
"N00000461",304,20,11,7,4,18,8,12,65,49,31,21,53,36
"N00000462",164,9,12,8,4,8,2,7,20,20,10,17,42,26
"N00000463",582,46,35,20,15,26,9,37,91,51,47,48,126,112
"N00000464",290,22,9,6,3,23,2,20,60,51,24,28,41,32
"N00000465",213,4,14,7,7,16,0,4,34,22,14,17,48,44
"N00000466",280,25,11,6,5,28,5,20,74,43,43,12,26,18
"N00000467",221,14,16,12,4,17,3,11,31,29,16,19,48,31
"N00000468",227,20,4,2,2,21,3,17,45,36,21,11,36,33
"N00000469",307,18,18,8,10,14,4,14,43,52,25,33,57,47
"N00000470",199,13,8,4,4,19,6,7,41,21,8,18,38,33
"N00000471",228,5,11,5,6,18,1,4,34,29,6,20,53,52
"N00000472",175,6,15,8,7,8,3,3,25,17,11,18,40,35
"N00000473",153,4,11,7,4,10,0,4,21,31,12,10,30,24
"N00000474",183,23,8,4,4,19,3,20,47,22,14,7,31,12
"N00000475",166,6,16,9,7,15,1,5,16,18,11,13,34,37
"N00000476",187,4,8,4,4,9,1,3,26,28,7,17,48,40
"N00000477",526,70,7,5,2,40,16,54,158,81,40,33,65,32
"N00000478",221,11,17,16,1,13,0,11,21,14,13,11,62,59
"N00000479",214,31,7,5,2,17,6,25,66,38,14,10,21,10
"N00000480",245,17,8,7,1,12,2,15,65,34,26,16,39,28
"N00000481",321,41,20,13,7,21,12,29,66,35,27,23,56,32
"N00000482",154,5,11,9,2,5,1,4,15,18,8,19,41,32
"N00000483",238,11,3,3,0,13,2,9,42,34,14,33,59,29
"N00000484",254,6,12,9,3,16,1,5,24,22,16,28,72,58
"N00000485",179,8,7,2,5,14,3,5,22,23,15,18,47,25
"N00000486",261,22,8,2,6,38,3,19,48,41,9,27,41,27
"N00000487",209,7,15,7,8,8,3,4,32,37,36,15,42,17
"N00000488",304,20,11,8,3,31,6,14,57,44,31,28,56,26
"N00000489",202,21,6,5,1,15,5,16,36,21,10,18,49,26
"N00000490",364,32,9,4,5,23,6,26,77,56,43,31,62,31
"N00000491",353,31,17,7,10,22,8,23,84,39,20,32,69,39
"N00000492",313,27,9,4,5,19,5,22,73,32,22,32,54,45
"N00000493",245,29,2,2,0,14,4,25,79,45,21,20,24,11
"N00000494",597,72,11,5,6,46,10,62,176,69,45,43,80,55
"N00000495",255,20,4,2,2,7,6,14,60,52,18,11,48,35
"N00000496",577,68,9,5,4,49,22,46,152,75,38,58,90,38
"N00000497",615,54,19,12,7,38,5,49,136,70,46,49,122,81
"N00000498",248,34,7,5,2,18,8,26,65,33,29,13,31,18
"N00000499",223,7,11,8,3,6,1,6,28,30,7,27,66,41
"N00000500",356,6,35,22,13,25,2,4,29,31,23,35,86,86
"N00000501",226,8,20,15,5,17,1,7,27,20,9,19,54,52
"N00000502",138,3,16,11,5,7,3,0,10,6,6,16,43,31
"N00000503",265,6,39,25,14,29,3,3,24,17,9,25,60,56
"N00000504",169,2,26,22,4,17,0,2,6,10,8,17,32,51
"N00000505",169,4,15,11,4,8,2,2,13,15,12,17,52,33
"N00000506",228,9,15,10,5,14,3,6,28,22,12,18,63,47
"N00000507",188,0,23,19,4,19,0,0,13,13,6,12,50,52
"N00000508",245,9,13,10,3,21,5,4,33,31,16,19,63,40
"N00000509",256,9,41,29,12,25,2,7,15,22,14,22,57,51
"N00000510",200,4,35,23,12,12,1,3,12,13,7,14,58,45
"N00000511",339,35,13,11,2,31,10,25,91,44,25,19,44,37
"N00000512",326,35,10,8,2,30,9,26,69,40,40,26,39,37
"N00000513",236,15,4,2,2,15,3,12,58,32,34,24,38,16
"N00000514",258,28,4,4,0,12,9,19,63,39,16,20,44,32
"N00000515",260,27,9,6,3,21,7,20,55,40,14,23,48,23
"N00000516",171,20,4,3,1,17,8,12,38,28,15,10,26,13
"N00000517",280,19,13,9,4,20,3,16,84,35,17,11,44,37
"N00000518",222,24,6,4,2,14,8,16,60,24,26,12,31,25
"N00000519",199,27,8,3,5,13,7,20,41,28,12,16,32,22
"N00000520",418,28,20,16,4,18,9,19,72,45,23,43,93,76
"N00000521",302,23,15,9,6,21,3,20,53,38,26,21,50,55
"N00000522",317,24,11,8,3,24,8,16,59,34,27,31,48,59
"N00000523",290,23,4,1,3,25,3,20,75,40,26,18,52,27
"N00000524",340,37,5,4,1,25,7,30,78,55,37,31,44,28
"N00000525",291,22,23,13,10,20,8,14,58,37,22,20,48,41
"N00000526",214,8,19,11,8,10,1,7,31,21,11,12,57,45
"N00000527",271,5,23,16,7,23,1,4,41,21,20,22,67,49
"N00000528",204,4,17,7,10,13,0,4,20,23,12,20,49,46
"N00000529",177,6,16,11,5,15,1,5,23,16,3,14,39,45
"N00000530",197,5,10,7,3,9,1,4,42,21,13,14,51,32
"N00000531",253,8,31,29,2,10,3,5,25,16,9,22,80,52
"N00000532",162,2,15,9,6,10,1,1,19,12,13,12,41,38
"N00000533",118,2,12,11,1,1,1,1,15,9,8,8,30,33
"N00000534",339,27,12,8,4,35,5,22,85,36,66,16,38,24
"N00000535",398,26,10,5,5,37,4,22,67,52,67,36,66,37
"N00000536",286,24,16,12,4,15,4,20,54,36,45,20,39,37
"N00000537",286,17,5,5,0,20,1,16,59,41,41,27,45,31
"N00000538",281,26,8,7,1,23,7,19,54,44,56,17,36,17
"N00000539",273,23,10,5,5,20,2,21,54,27,43,18,56,22
"N00000540",235,11,4,4,0,16,5,6,40,23,23,20,57,41
"N00000541",303,18,14,10,4,15,6,12,72,50,22,23,57,32
"N00000542",174,14,7,5,2,13,5,9,42,21,17,8,30,22
"N00000543",275,11,21,10,11,24,1,10,34,28,16,33,56,52
"N00000544",208,5,22,14,8,12,0,5,26,18,9,28,51,37
"N00000545",208,9,15,8,7,13,2,7,27,33,15,20,42,34
"N00000546",213,4,18,7,11,13,1,3,27,17,10,26,59,39
"N00000547",236,7,14,9,5,16,1,6,27,22,14,22,67,47
"N00000548",221,11,19,14,5,18,2,9,24,16,16,18,55,44
"N00000549",149,5,30,19,11,10,0,5,15,8,9,9,31,32
"N00000550",298,22,14,7,7,21,6,16,67,34,24,20,59,37
"N00000551",174,5,27,20,7,11,1,4,22,16,5,10,39,39
"N00000552",179,6,10,7,3,15,1,5,27,20,21,17,32,31
"N00000553",249,5,29,20,9,28,2,3,28,23,8,20,61,47
"N00000554",172,2,22,17,5,9,1,1,10,14,8,15,49,43
"N00000555",181,5,26,17,9,9,3,2,21,14,9,15,44,38
"N00000556",226,6,22,14,8,21,3,3,33,15,17,23,46,43
"N00000557",384,26,9,6,3,41,8,18,54,59,83,19,61,32
"N00000558",313,26,9,7,2,24,6,20,65,38,46,21,51,33
"N00000559",252,20,4,3,1,21,4,16,39,37,44,21,35,31
"N00000560",305,14,12,6,6,34,1,13,52,37,50,31,41,34
"N00000561",331,29,14,13,1,23,3,26,64,38,61,32,43,27
"N00000562",272,23,3,1,2,26,4,19,37,30,36,24,44,49
"N00000563",658,24,76,54,22,49,5,19,85,65,44,64,140,111
"N00000564",223,11,14,8,6,9,1,10,33,18,21,18,53,46
"N00000565",167,6,11,7,4,2,1,5,27,22,9,25,39,26
"N00000566",214,14,12,7,5,13,4,10,50,28,21,14,32,30
"N00000567",362,30,12,4,8,30,6,24,90,44,34,34,51,37
"N00000568",262,8,10,7,3,12,2,6,37,38,21,31,75,30
"N00000569",257,10,11,6,5,17,1,9,29,27,16,28,63,56
"N00000570",253,28,5,2,3,23,9,19,76,38,20,22,29,12
"N00000571",231,31,2,1,1,25,5,26,51,27,31,13,32,19
"N00000572",428,49,13,7,6,43,16,33,118,65,27,25,66,22
"N00000573",271,54,4,2,2,19,12,42,84,33,30,8,31,8
"N00000574",305,50,7,6,1,28,7,43,102,20,32,16,42,8
"N00000575",341,30,7,6,1,22,4,26,65,32,84,20,52,29
"N00000576",261,12,14,8,6,23,1,11,40,43,26,27,45,31
"N00000577",328,21,27,17,10,27,4,17,67,36,50,27,39,34
"N00000578",495,44,31,16,15,44,7,37,127,54,57,25,69,44
"N00000579",315,30,16,11,5,30,5,25,77,27,34,19,41,41
"N00000580",337,19,12,7,5,16,6,13,65,37,54,37,46,51
"N00000581",382,34,6,2,4,36,8,26,81,39,69,28,55,34
"N00000582",303,25,5,4,1,26,7,18,49,45,55,25,38,35
"N00000583",230,18,7,2,5,16,2,16,51,22,29,16,38,33
"N00000584",324,33,9,8,1,26,9,24,74,34,60,23,35,30
"N00000585",351,21,11,7,4,30,6,15,63,42,60,30,58,36
"N00000586",327,19,6,2,4,16,3,16,84,40,64,27,37,34
"N00000587",347,27,12,8,4,33,4,23,70,44,68,29,39,25
"N00000588",284,40,7,4,3,18,6,34,58,38,34,22,34,33
"N00000589",435,35,21,8,13,41,9,26,79,56,99,27,38,39
"N00000590",306,23,8,4,4,32,6,17,55,36,62,16,41,33
"N00000591",315,24,6,4,2,30,2,22,60,37,60,24,48,26
"N00000592",350,26,10,6,4,25,2,24,79,39,38,33,50,50
"N00000593",408,32,17,13,4,48,8,24,94,42,69,31,42,33
"N00000594",271,24,7,5,2,31,5,19,48,27,57,17,33,27
"N00000595",384,41,7,5,2,33,11,30,75,46,64,23,49,46
"N00000596",230,22,12,8,4,19,5,17,34,28,26,19,48,22
"N00000597",176,6,14,10,4,12,1,5,12,9,16,22,50,35
"N00000598",231,5,33,19,14,6,2,3,30,26,7,22,65,37
"N00000599",182,4,25,18,7,8,0,4,12,10,13,18,50,42
"N00000600",222,10,19,14,5,13,2,8,41,19,14,21,62,23
"N00000601",209,13,9,6,3,3,4,9,39,30,11,23,44,37
"N00000602",153,8,2,2,0,3,3,5,24,21,13,19,42,21
"N00000603",278,16,13,10,3,15,7,9,59,39,29,18,50,39
"N00000604",250,25,8,5,3,24,8,17,38,31,21,21,36,46
"N00000605",351,29,15,8,7,28,7,22,57,46,34,33,61,48
"N00000606",243,12,3,2,1,20,3,9,51,41,18,19,49,30
"N00000607",222,5,11,10,1,20,2,3,23,20,20,10,67,46
"N00000608",281,18,6,5,1,24,8,10,61,43,47,19,36,27
"N00000609",276,19,12,4,8,24,5,14,51,31,42,22,39,36
"N00000610",302,31,6,2,4,17,7,24,57,51,24,25,57,34
"N00000611",226,15,13,7,6,14,9,6,41,37,21,20,27,38
"N00000612",413,7,38,21,17,26,2,5,36,37,9,38,113,109
"N00000613",166,4,16,9,7,8,2,2,23,9,2,14,52,38
"N00000614",168,4,20,17,3,6,1,3,13,15,7,13,57,33
"N00000615",104,3,10,5,5,3,2,1,11,11,1,9,29,27
"N00000616",215,4,18,12,6,11,3,1,17,19,15,16,70,45
"N00000617",230,3,28,23,5,13,1,2,16,22,12,20,65,51
"N00000618",437,7,33,20,13,26,3,4,54,51,21,34,110,101
"N00000619",279,27,7,5,2,20,5,22,64,47,27,14,52,21
"N00000620",292,19,13,4,9,26,4,15,63,39,21,31,51,29
"N00000621",284,14,23,16,7,15,1,13,56,29,23,17,69,38
"N00000622",287,16,15,6,9,26,5,11,49,46,19,25,51,40
"N00000623",233,24,14,11,3,20,1,23,32,19,42,20,35,27
"N00000624",355,23,3,3,0,43,4,19,73,36,62,29,55,31
"N00000625",199,13,18,12,6,14,1,12,31,21,21,11,37,33
"N00000626",357,33,13,10,3,36,7,26,74,43,57,26,35,40
"N00000627",333,23,5,4,1,25,5,18,61,48,60,19,53,39
"N00000628",308,20,17,15,2,28,4,16,48,33,48,27,64,23
"N00000629",294,25,13,9,4,17,9,16,51,39,38,27,46,38
"N00000630",195,10,24,19,5,17,1,9,26,9,12,7,44,46
"N00000631",280,16,11,9,2,21,3,13,59,32,52,25,36,28
"N00000632",333,33,9,7,2,29,4,29,68,34,61,19,51,29
"N00000633",242,30,6,2,4,21,7,23,52,26,37,19,29,22
"N00000634",351,39,5,2,3,41,7,32,73,46,68,23,32,24
"N00000635",308,17,8,6,2,19,3,14,56,32,72,24,46,34
"N00000636",296,15,8,8,0,21,1,14,48,38,58,18,43,47
"N00000637",593,45,34,19,15,45,12,33,120,62,34,53,127,73
"N00000638",291,15,26,16,10,31,3,12,64,30,20,31,43,31
"N00000639",317,26,19,11,8,32,8,18,65,40,31,18,51,35
"N00000640",262,14,17,12,5,21,2,12,40,22,30,19,57,42
"N00000641",256,18,7,5,2,22,5,13,87,30,20,19,33,20
"N00000642",278,12,11,9,2,19,1,11,49,42,25,22,60,38
"N00000643",326,16,28,20,8,30,5,11,56,32,70,15,30,49
"N00000644",381,22,28,13,15,28,4,18,46,52,64,22,48,71
"N00000645",351,11,23,17,6,39,2,9,47,39,69,19,56,48
"N00000646",281,7,17,10,7,40,1,6,48,23,56,18,37,35
"N00000647",540,12,61,35,26,35,1,11,71,48,49,37,124,103
"N00000648",273,13,17,11,6,25,3,10,49,22,48,27,40,32
"N00000649",293,26,11,6,5,26,3,23,60,20,64,21,38,27
"N00000650",433,33,26,18,8,23,10,23,72,64,56,29,76,54
"N00000651",202,4,34,23,11,12,1,3,13,12,11,13,53,50
"N00000652",398,27,18,12,6,30,11,16,80,63,28,32,69,51
"N00000653",227,12,8,7,1,23,5,7,45,33,26,13,32,35
"N00000654",207,8,22,14,8,16,4,4,26,17,25,12,40,41
"N00000655",269,14,37,33,4,15,6,8,53,36,25,10,46,33
"N00000656",185,7,24,11,13,14,4,3,27,19,11,11,39,33
"N00000657",607,27,30,18,12,59,7,20,92,74,70,57,102,96
"N00000658",272,16,15,10,5,23,3,13,45,30,48,22,33,40
"N00000659",296,17,11,6,5,30,5,12,37,32,39,31,46,53
"N00000660",288,8,27,18,9,21,2,6,35,24,27,22,55,69
"N00000661",290,31,15,11,4,26,3,28,45,26,56,9,46,36
"N00000662",274,10,19,13,6,21,3,7,28,36,29,22,53,56
"N00000663",303,25,16,7,9,23,6,19,45,36,54,22,46,36
"N00000664",269,25,9,4,5,21,4,21,34,32,39,20,49,40
"N00000665",330,11,16,9,7,35,2,9,59,30,57,18,57,47
"N00000666",306,5,10,5,5,38,0,5,41,33,52,24,60,43
"N00000667",375,28,20,12,8,62,8,20,57,35,56,23,45,49
"N00000668",247,3,33,20,13,23,1,2,21,22,26,13,45,61
"N00000669",329,14,16,10,6,41,2,12,58,34,45,28,46,47
"N00000670",210,10,16,11,5,11,1,9,18,24,24,14,47,46
"N00000671",163,4,14,12,2,11,1,3,14,19,11,21,37,32
"N00000672",231,9,11,6,5,13,2,7,35,37,19,25,47,35
"N00000673",654,18,46,23,23,56,6,12,89,76,52,68,145,104
"N00000674",226,15,8,3,5,13,2,13,60,38,22,12,35,23
"N00000675",287,30,11,8,3,33,7,23,65,58,36,14,24,16
"N00000676",499,33,29,22,7,32,9,24,97,55,51,35,91,76
"N00000677",230,14,34,22,12,11,2,12,24,23,15,14,50,45
"N00000678",384,15,29,21,8,45,4,11,63,27,72,30,55,48
"N00000679",405,27,14,8,6,52,7,20,71,48,64,33,61,35
"N00000680",291,7,31,22,9,27,2,5,32,37,39,18,54,46
"N00000681",278,13,12,9,3,19,0,13,39,24,48,30,55,38
"N00000682",349,30,22,16,6,33,5,25,63,28,58,29,52,34
"N00000683",277,8,14,12,2,17,0,8,54,28,42,27,45,42
"N00000684",429,22,40,26,14,33,10,12,60,45,69,35,63,62
"N00000685",237,6,35,26,9,17,3,3,18,25,17,21,56,42
"N00000686",355,22,14,8,6,41,2,20,59,32,87,23,40,37
"N00000687",281,9,20,13,7,24,3,6,29,27,46,23,51,52
"N00000688",306,18,16,11,5,18,0,18,56,35,56,27,41,39
"N00000689",290,13,13,11,2,30,1,12,47,31,65,20,41,30
"N00000690",219,9,13,6,7,18,3,6,32,26,16,14,45,46
"N00000691",234,7,30,18,12,20,4,3,21,15,16,15,63,47
"N00000692",188,3,35,25,10,6,2,1,15,13,13,16,48,39
"N00000693",209,7,25,19,6,12,0,7,25,26,11,5,49,49
"N00000694",626,35,52,30,22,72,10,25,110,60,51,42,131,73
"N00000695",386,20,33,20,13,30,4,16,52,48,27,30,87,59
"N00000696",136,7,22,15,7,4,2,5,18,10,7,11,27,30
"N00000697",254,34,9,5,4,23,6,28,59,37,39,11,27,15
"N00000698",332,20,20,17,3,26,6,14,67,49,40,18,39,53
"N00000699",162,3,22,18,4,7,0,3,28,14,9,10,31,38
"N00000700",218,3,25,15,10,17,1,2,21,26,9,18,56,43
"N00000701",150,4,13,9,4,13,1,3,10,17,12,13,36,32
"N00000702",541,36,26,15,11,33,11,25,114,64,54,44,89,81
"N00000703",269,7,19,17,2,22,4,3,44,33,30,18,49,47
"N00000704",487,35,19,14,5,47,13,22,80,67,65,30,84,60
"N00000705",475,38,20,12,8,43,7,31,112,52,57,30,77,46
"N00000706",304,2,24,19,5,23,0,2,29,33,48,27,50,68
"N00000707",270,14,22,12,10,25,3,11,43,28,38,19,48,33
"N00000708",337,12,13,10,3,28,5,7,53,41,72,18,54,46
"N00000709",345,22,16,8,8,31,7,15,60,37,72,16,52,39
"N00000710",240,11,8,2,6,24,2,9,35,27,51,18,45,21
"N00000711",372,27,21,15,6,24,6,21,58,58,29,32,63,60
"N00000712",260,22,10,8,2,22,6,16,40,36,54,18,29,29
"N00000713",314,11,21,15,6,26,2,9,55,31,54,29,48,39
"N00000714",296,17,17,15,2,33,4,13,49,25,65,21,40,29
"N00000715",480,26,13,5,8,41,7,19,105,85,30,41,87,52
"N00000716",685,51,17,11,6,68,13,38,192,114,55,38,94,56
"N00000717",386,36,8,7,1,28,7,29,107,59,40,23,60,25
"N00000718",1354,161,47,25,22,109,21,140,333,224,114,78,166,122
"N00000719",183,22,4,1,3,15,4,18,56,34,13,13,19,7
"N00000720",344,48,11,6,5,34,6,42,107,54,27,9,37,17
"N00000721",335,23,15,7,8,29,2,21,58,44,76,17,38,35
"N00000722",331,10,13,8,5,22,3,7,63,43,53,21,53,53
"N00000723",325,24,21,13,8,32,3,21,46,27,78,17,34,46
"N00000724",335,29,14,9,5,31,8,21,45,50,76,18,29,43
"N00000725",326,20,19,11,8,34,4,16,57,33,73,25,31,34
"N00000726",305,11,24,22,2,23,1,10,43,32,74,14,35,49
"N00000727",199,5,17,11,6,6,0,5,26,21,12,19,41,52
"N00000728",346,25,21,15,6,17,3,22,77,65,42,16,53,30
"N00000729",263,10,10,5,5,36,3,7,48,47,22,19,46,25
"N00000730",244,10,7,5,2,24,3,7,42,34,18,23,47,39
"N00000731",176,3,10,10,0,8,1,2,25,15,11,17,43,44
"N00000732",425,27,18,4,14,23,5,22,96,68,24,34,81,54
"N00000733",245,15,8,4,4,25,5,10,39,40,14,22,57,25
"N00000734",284,3,16,9,7,30,0,3,50,34,25,17,69,40
"N00000735",293,25,12,4,8,31,7,18,53,35,58,15,39,25
"N00000736",265,9,18,12,6,28,1,8,51,27,47,12,36,37
"N00000737",284,26,11,10,1,26,11,15,64,25,49,16,44,23
"N00000738",300,24,15,10,5,24,2,22,58,30,61,15,37,36
"N00000739",338,27,7,3,4,27,4,23,58,42,93,18,37,29
"N00000740",386,39,16,9,7,39,4,35,74,43,71,29,55,20
"N00000741",258,40,5,4,1,8,6,34,78,43,35,15,16,18
"N00000742",194,16,8,4,4,10,3,13,40,33,20,16,22,29
"N00000743",192,6,21,13,8,15,2,4,25,18,8,12,38,49
"N00000744",190,15,5,1,4,11,3,12,31,28,20,18,36,26
"N00000745",343,36,8,6,2,29,14,22,91,55,20,32,40,32
"N00000746",358,14,36,21,15,23,6,8,46,46,26,29,60,78
"N00000747",300,23,12,5,7,19,5,18,77,49,31,12,40,37
"N00000748",330,41,2,2,0,22,10,31,81,63,34,16,51,20
"N00000749",246,9,16,14,2,11,3,6,45,33,21,20,54,37
"N00000750",228,16,16,10,6,12,2,14,44,28,18,23,34,37
"N00000751",333,36,17,9,8,12,4,32,69,61,21,21,54,42
"N00000752",279,24,5,1,4,17,6,18,71,51,28,9,45,29
"N00000753",312,37,4,4,0,27,7,30,71,44,47,19,31,32
"N00000754",312,34,6,2,4,23,7,27,83,46,28,25,39,28
"N00000755",263,30,7,5,2,32,11,19,77,41,14,19,22,21
"N00000756",256,19,8,4,4,15,8,11,55,36,25,22,39,37
"N00000757",296,22,4,1,3,25,10,12,92,49,27,33,30,14
"N00000758",297,11,37,17,20,21,3,8,30,34,18,23,66,57
"N00000759",213,21,5,1,4,29,8,13,46,23,14,19,34,22
"N00000760",192,5,15,9,6,9,1,4,25,12,10,16,49,51
"N00000761",321,15,21,13,8,27,6,9,33,39,27,23,74,62
"N00000762",163,2,17,6,11,4,0,2,21,22,13,14,33,37
"N00000763",298,14,37,18,19,19,3,11,41,38,16,22,67,44
"N00000764",195,10,11,4,7,10,1,9,35,28,25,15,36,25
"N00000765",274,6,28,19,9,22,0,6,26,35,19,22,61,55
"N00000766",520,27,37,23,14,36,6,21,78,71,37,52,96,86
"N00000767",240,12,14,10,4,32,1,11,48,34,12,13,39,36
"N00000768",200,9,13,10,3,17,4,5,34,29,15,15,36,32
"N00000769",307,33,6,1,5,38,7,26,79,46,34,17,37,17
"N00000770",259,32,8,6,2,31,3,29,60,42,28,15,25,18
"N00000771",171,5,18,12,6,3,0,5,25,20,11,17,43,29
"N00000772",317,20,12,8,4,25,5,15,66,42,49,23,49,31
"N00000773",292,25,15,8,7,29,9,16,55,27,28,25,43,45
"N00000774",742,38,48,32,16,58,7,31,110,76,61,87,144,120
"N00000775",217,17,9,6,3,12,4,13,30,20,31,25,41,32
"N00000776",227,3,21,11,10,15,2,1,13,17,15,24,44,75
"N00000777",646,50,34,17,17,46,13,37,127,81,99,36,89,84
"N00000778",311,21,6,3,3,29,4,17,72,37,67,12,39,28
"N00000779",409,31,23,18,5,24,8,23,76,67,58,26,51,53
"N00000780",383,37,14,8,6,33,7,30,82,65,61,17,43,31
"N00000781",377,30,9,6,3,28,5,25,100,78,40,28,43,21
"N00000782",365,36,8,8,0,35,8,28,73,42,79,18,44,30
"N00000783",411,25,22,13,9,34,2,23,68,51,66,27,52,66
"N00000784",304,25,11,7,4,18,6,19,63,35,63,20,34,35
"N00000785",260,14,12,6,6,23,3,11,52,20,49,21,32,37
"N00000786",260,23,10,6,4,21,2,21,51,34,39,13,38,31
"N00000787",306,23,7,7,0,23,1,22,55,42,56,21,37,42
"N00000788",311,26,12,4,8,25,2,24,65,38,57,19,31,38
"N00000789",762,54,45,32,13,64,11,43,118,91,68,86,111,125
"N00000790",393,21,19,16,3,29,1,20,94,52,57,31,48,42
"N00000791",274,32,8,2,6,23,7,25,47,30,30,18,46,40
"N00000792",280,30,13,7,6,30,7,23,71,31,25,24,31,25
"N00000793",337,25,9,7,2,31,8,17,72,37,57,22,49,35
"N00000794",324,30,23,16,7,26,3,27,77,33,58,13,19,45
"N00000795",361,28,6,6,0,29,6,22,77,49,73,23,44,32
"N00000796",245,18,12,8,4,23,6,12,45,29,21,11,41,45
"N00000797",271,15,16,13,3,10,4,11,56,33,34,20,43,44
"N00000798",379,39,13,11,2,37,7,32,76,40,76,17,48,33
"N00000799",355,29,17,7,10,31,8,21,58,50,48,23,54,45
"N00000800",301,39,5,4,1,21,9,30,54,44,58,15,41,24
"N00000801",373,39,12,5,7,36,8,31,114,40,65,12,31,24
"N00000802",208,21,6,5,1,15,7,14,49,26,25,12,30,24
"N00000803",295,25,13,6,7,18,4,21,61,37,43,35,26,37
"N00000804",318,41,7,3,4,18,14,27,78,36,67,17,27,27
"N00000805",259,29,10,6,4,14,6,23,60,32,49,13,24,28
"N00000806",251,9,18,15,3,21,1,8,41,21,27,14,57,43
"N00000807",357,17,13,10,3,42,2,15,63,45,40,23,54,60
"N00000808",167,4,8,6,2,8,1,3,25,19,25,13,32,33
"N00000809",373,19,37,25,12,20,5,14,51,46,41,31,66,62
"N00000810",300,18,9,6,3,22,3,15,62,36,39,28,48,38
"N00000811",235,8,23,19,4,20,6,2,28,16,15,22,44,59
"N00000812",213,11,20,12,8,11,1,10,19,23,25,16,40,48
"N00000813",344,26,10,7,3,24,2,24,57,53,34,35,51,54
"N00000814",201,21,9,7,2,13,6,15,44,21,19,11,27,36
"N00000815",358,48,6,3,3,42,10,38,82,65,33,16,45,21
"N00000816",358,33,20,14,6,22,4,29,82,37,35,24,47,58
"N00000817",209,30,5,4,1,16,9,21,74,35,9,8,18,14
"N00000818",241,12,16,13,3,13,3,9,38,40,24,19,49,30
"N00000819",192,7,10,8,2,15,2,5,23,17,8,22,47,43
"N00000820",285,9,18,12,6,15,1,8,50,43,15,25,50,60
"N00000821",202,4,15,12,3,13,1,3,25,23,18,11,47,46
"N00000822",156,10,12,8,4,4,2,8,30,19,14,13,25,29
"N00000823",269,15,19,12,7,18,3,12,59,40,23,21,43,31
"N00000824",194,5,35,23,12,10,2,3,29,23,10,22,28,32
"N00000825",282,13,12,8,4,26,1,12,57,56,23,18,40,37
"N00000826",218,11,19,13,6,20,4,7,52,33,24,7,29,23
"N00000827",228,14,18,12,6,18,3,11,45,38,13,17,35,30
"N00000828",171,8,16,15,1,16,0,8,25,28,14,14,22,28
"N00000829",220,11,8,5,3,23,1,10,52,34,16,14,29,33
"N00000830",186,4,43,38,5,15,0,4,11,19,7,10,41,36
"N00000831",243,8,26,18,8,30,2,6,28,51,16,14,36,34
"N00000832",203,8,27,23,4,21,1,7,25,24,11,20,34,33
"N00000833",181,8,17,12,5,13,3,5,26,30,9,10,42,26
"N00000834",243,17,22,14,8,19,0,17,50,36,17,21,32,29
"N00000835",217,11,23,16,7,25,1,10,29,20,7,13,45,44
"N00000836",264,13,32,25,7,37,0,13,25,30,19,17,48,43
"N00000837",253,6,35,27,8,28,0,6,39,23,19,13,44,46
"N00000838",213,6,26,14,12,19,1,5,31,23,16,18,42,32
"N00000839",254,17,26,16,10,25,1,16,57,42,11,13,36,27
"N00000840",190,12,15,10,5,22,2,10,38,34,13,8,25,23
"N00000841",184,5,50,37,13,16,2,3,18,8,4,11,38,34
"N00000842",396,5,101,80,21,67,0,5,31,34,10,17,63,68
"N00000843",175,2,28,19,9,16,1,1,22,15,4,10,37,41
"N00000844",149,7,20,14,6,6,1,6,17,21,8,12,34,24
"N00000845",161,2,26,21,5,11,0,2,15,17,9,13,40,28
"N00000846",183,6,30,20,10,15,1,5,12,23,5,11,35,46
"N00000847",610,4,120,90,30,84,1,3,48,62,27,39,112,114
"N00000848",163,1,31,27,4,7,0,1,10,13,5,9,31,56
"N00000849",236,7,45,33,12,14,2,5,14,33,9,10,48,56
"N00000850",193,1,34,21,13,17,0,1,11,25,8,15,39,43
"N00000851",174,3,33,21,12,13,1,2,9,10,5,17,50,34
"N00000852",811,14,183,148,35,81,2,12,55,77,27,50,142,182
"N00000853",209,5,57,51,6,29,3,2,6,13,10,12,38,39
"N00000854",533,5,123,100,23,70,1,4,36,46,14,24,116,99
"N00000855",135,17,9,3,6,5,2,15,40,24,6,8,12,14
"N00000856",132,34,3,0,3,6,2,32,44,19,6,3,8,9
"N00000857",275,61,12,10,2,23,12,49,75,40,20,12,16,16
"N00000858",179,24,15,12,3,5,4,20,57,25,3,13,22,15
"N00000859",213,26,4,2,2,5,4,22,60,44,15,16,24,19
"N00000860",287,56,6,3,3,23,5,51,97,41,20,13,21,10
"N00000861",210,41,5,3,2,17,7,34,77,31,13,6,14,6
"N00000862",664,112,11,8,3,63,15,97,199,99,45,30,64,41
"N00000863",210,25,3,3,0,14,2,23,71,35,20,11,20,11
"N00000864",231,46,5,4,1,34,8,38,67,28,13,9,17,12
"N00000865",259,46,11,7,4,25,5,41,73,33,13,13,32,13
"N00000866",277,33,8,3,5,14,5,28,85,44,15,17,37,24
"N00000867",218,39,6,6,0,9,9,30,48,34,10,15,36,21
"N00000868",229,38,6,5,1,15,8,30,72,33,17,6,29,13
"N00000869",143,13,18,15,3,17,4,9,24,13,8,8,19,23
"N00000870",319,38,28,23,5,24,8,30,77,44,21,20,49,18
"N00000871",239,31,12,6,6,17,8,23,60,34,21,9,32,23
"N00000872",189,16,6,4,2,8,5,11,48,32,7,13,33,26
"N00000873",250,4,36,28,8,33,1,3,30,17,12,9,53,56
"N00000874",410,63,64,44,20,23,8,55,69,36,11,20,56,68
"N00000875",194,4,36,25,11,19,0,4,17,25,3,10,37,43
"N00000876",134,3,37,32,5,6,1,2,14,10,2,8,24,30
"N00000877",258,5,36,26,10,34,0,5,13,32,4,27,47,60
"N00000878",172,3,35,31,4,11,0,3,10,13,9,15,29,47
"N00000879",696,9,103,81,22,82,1,8,69,80,26,49,132,146
"N00000880",221,6,39,32,7,22,0,6,16,18,10,22,38,50
"N00000881",221,7,31,23,8,16,1,6,16,25,3,21,43,59
"N00000882",184,1,23,17,6,10,1,0,15,16,8,12,49,50
"N00000883",200,6,27,17,10,10,1,5,21,22,4,19,41,50
"N00000884",168,2,27,17,10,4,2,0,19,25,7,19,32,33
"N00000885",476,27,62,44,18,29,5,22,59,60,15,43,91,90
"N00000886",199,22,11,4,7,10,2,20,63,26,6,14,26,21
"N00000887",220,37,13,10,3,14,1,36,58,24,9,11,30,24
"N00000888",250,31,16,11,5,9,2,29,74,39,10,18,39,14
"N00000889",191,54,4,3,1,20,2,52,50,19,11,11,18,4
"N00000890",255,48,11,8,3,14,8,40,62,40,12,22,26,20
"N00000891",299,35,25,12,13,17,3,32,73,56,13,13,34,33
"N00000892",260,22,6,3,3,29,0,22,70,41,13,11,39,29
"N00000893",244,44,6,5,1,25,3,41,61,33,10,19,29,17
"N00000894",220,40,11,9,2,14,5,35,56,30,12,8,28,21
"N00000895",195,13,12,9,3,16,2,11,55,29,9,4,30,27
"N00000896",219,36,9,5,4,11,1,35,69,32,8,17,25,12
"N00000897",261,49,13,7,6,31,2,47,82,31,8,10,24,13
"N00000898",252,47,12,5,7,29,3,44,63,34,16,11,30,10
"N00000899",251,43,21,17,4,21,1,42,45,24,5,22,33,37
"N00000900",166,3,28,17,11,18,0,3,19,23,6,9,32,28
"N00000901",275,28,17,12,5,39,4,24,70,43,13,15,24,26
"N00000902",257,39,10,5,5,30,2,37,69,29,9,16,33,22
"N00000903",149,5,23,17,6,14,0,5,10,15,12,22,24,24
"N00000904",370,66,28,15,13,32,6,60,65,54,11,13,61,40
"N00000905",260,28,32,13,19,14,3,25,43,33,10,21,42,37
"N00000906",203,9,7,3,4,11,1,8,30,38,8,21,31,48
"N00000907",227,8,34,23,11,18,2,6,26,21,16,11,51,42
"N00000908",236,6,23,13,10,17,3,3,27,38,6,17,52,50
"N00000909",176,3,42,37,5,12,0,3,15,20,8,18,22,36
"N00000910",206,7,27,22,5,16,1,6,19,24,4,20,49,40
"N00000911",163,3,27,22,5,14,0,3,11,21,4,14,25,44
"N00000912",171,3,26,20,6,21,1,2,8,18,6,10,42,37
"N00000913",241,3,29,24,5,25,0,3,13,27,6,22,57,59
"N00000914",223,6,10,7,3,32,2,4,30,24,8,24,33,56
"N00000915",173,4,15,7,8,12,1,3,22,23,9,17,36,35
"N00000916",171,7,10,8,2,4,2,5,19,35,11,18,36,31
"N00000917",162,9,13,7,6,9,4,5,28,17,7,16,34,29
"N00000918",194,10,7,3,4,17,2,8,27,30,12,21,34,36
"N00000919",164,5,9,6,3,15,1,4,34,26,10,11,31,23
"N00000920",103,3,10,5,5,1,1,2,10,14,4,12,29,20
"N00000921",492,42,16,8,8,69,9,33,86,64,44,45,71,55
"N00000922",207,15,10,5,5,17,5,10,37,38,13,12,41,24
"N00000923",193,13,7,5,2,12,1,12,31,35,6,16,42,31
"N00000924",161,7,12,5,7,21,2,5,21,27,9,9,31,24
"N00000925",215,4,8,7,1,26,3,1,23,39,5,15,45,50
"N00000926",214,5,25,20,5,24,1,4,16,40,8,8,45,43
"N00000927",310,11,20,18,2,17,4,7,113,41,6,17,48,37
"N00000928",269,16,22,13,9,28,3,13,51,54,18,17,40,23
"N00000929",324,9,69,61,8,35,0,9,36,39,8,18,66,44
"N00000930",257,7,43,37,6,21,1,6,30,38,8,14,44,52
"N00000931",406,7,84,73,11,57,2,5,29,45,8,20,77,79
"N00000932",282,9,63,55,8,15,4,5,34,38,10,15,59,39
"N00000933",213,9,39,29,10,14,1,8,37,28,9,9,35,33
"N00000934",213,6,22,16,6,20,1,5,32,37,10,13,39,34
"N00000935",191,5,29,20,9,18,1,4,21,37,5,6,26,44
"N00000936",372,6,62,53,9,38,1,5,32,42,12,22,81,77
"N00000937",334,10,33,26,7,40,3,7,37,47,8,22,57,80
"N00000938",264,5,24,18,6,49,0,5,26,32,15,16,48,49
"N00000939",138,2,21,18,3,16,1,1,10,15,2,10,30,32
"N00000940",181,4,17,11,6,16,1,3,21,26,7,12,38,40
"N00000941",238,55,3,2,1,23,7,48,78,31,18,9,15,6
"N00000942",200,10,14,11,3,13,1,9,51,38,17,17,30,10
"N00000943",183,13,7,6,1,14,3,10,41,29,18,13,28,20
"N00000944",175,1,25,14,11,28,0,1,12,19,3,12,34,41
"N00000945",200,25,4,2,2,15,5,20,49,33,20,14,27,13
"N00000946",289,6,47,33,14,11,1,5,18,43,14,31,61,58
"N00000947",183,8,29,19,10,15,2,6,20,27,7,14,31,32
"N00000948",171,11,13,8,5,13,2,9,25,28,14,14,28,25
"N00000949",226,11,30,21,9,13,1,10,29,29,13,19,38,44
"N00000950",218,9,16,15,1,17,2,7,26,32,14,17,47,40
"N00000951",167,9,14,8,6,15,4,5,26,18,12,13,28,32
"N00000952",280,23,18,11,7,25,3,20,38,23,16,26,63,48
"N00000953",169,7,11,6,5,9,0,7,34,18,8,15,38,29
"N00000954",189,7,16,8,8,26,1,6,28,17,16,13,31,35
"N00000955",302,26,13,8,5,29,2,24,94,34,21,16,31,38
"N00000956",358,28,21,12,9,24,6,22,82,57,22,29,62,33
"N00000957",366,93,9,6,3,30,12,81,95,60,32,12,24,11
"N00000958",216,37,3,1,2,16,11,26,52,41,18,9,22,18
"N00000959",315,46,4,2,2,31,8,38,89,60,17,15,32,21
"N00000960",351,99,10,3,7,39,11,88,99,46,28,7,16,7
"N00000961",215,37,0,0,0,20,10,27,77,32,15,8,13,13
"N00000962",259,26,14,8,6,25,2,24,51,29,6,20,49,39
"N00000963",196,17,6,5,1,17,3,14,45,42,4,14,27,24
"N00000964",232,28,4,2,2,18,6,22,58,61,7,9,30,17
"N00000965",229,21,11,8,3,21,4,17,57,35,10,20,35,19
"N00000966",259,38,6,1,5,16,6,32,76,47,14,15,31,16
"N00000967",283,24,9,8,1,31,5,19,68,52,20,16,36,27
"N00000968",186,29,8,4,4,10,8,21,63,22,10,10,21,13
"N00000969",136,10,8,6,2,9,1,9,18,19,6,15,34,17
"N00000970",375,48,33,24,9,10,8,40,72,58,16,32,62,44
"N00000971",176,9,11,5,6,11,2,7,16,20,1,15,57,36
"N00000972",228,9,32,23,9,11,1,8,21,22,7,16,64,46
"N00000973",236,19,21,13,8,15,3,16,64,30,16,12,35,24
"N00000974",205,11,27,17,10,12,0,11,24,24,7,18,47,35
"N00000975",190,3,29,21,8,13,0,3,23,27,8,11,44,32
"N00000976",114,3,14,6,8,2,0,3,15,10,1,15,24,30
"N00000977",202,5,9,6,3,22,1,4,26,28,5,16,40,51
"N00000978",191,9,21,6,15,16,0,9,23,26,4,15,44,33
"N00000979",183,15,13,7,6,21,0,15,25,29,2,14,29,35
"N00000980",203,10,16,6,10,28,1,9,26,29,6,15,31,42
"N00000981",166,9,10,4,6,17,0,9,34,12,6,8,30,40
"N00000982",211,11,9,3,6,18,5,6,37,30,5,24,36,41
"N00000983",241,4,22,17,5,22,2,2,27,31,7,31,39,58
"N00000984",297,20,15,8,7,66,2,18,47,43,9,21,56,20
"N00000985",178,6,28,23,5,16,1,5,17,12,1,11,40,47
"N00000986",178,10,20,10,10,15,4,6,29,19,8,12,28,37
"N00000987",271,27,16,13,3,52,5,22,48,20,7,17,45,39
"N00000988",126,8,11,5,6,17,3,5,16,13,5,9,24,23
"N00000989",199,5,29,25,4,14,0,5,21,19,6,11,44,50
"N00000990",221,9,20,8,12,27,1,8,30,19,8,12,46,50
"N00000991",186,7,24,13,11,5,0,7,23,20,2,20,48,37
"N00000992",366,24,21,9,12,14,1,23,76,60,18,31,68,54
"N00000993",183,5,25,16,9,12,0,5,29,22,9,15,34,32
"N00000994",709,40,62,42,20,39,3,37,126,90,26,52,150,124
"N00000995",142,16,9,6,3,9,0,16,26,23,9,12,25,13
"N00000996",270,57,31,28,3,21,6,51,76,32,20,8,17,8
"N00000997",188,36,7,3,4,20,2,34,48,22,21,9,15,10
"N00000998",226,37,13,7,6,18,5,32,51,39,15,9,31,13
"N00000999",183,17,14,9,5,9,7,10,29,28,13,16,29,28
"N00001000",239,27,5,4,1,20,6,21,66,33,14,18,26,30
"N00001001",230,24,15,9,6,18,3,21,50,33,7,13,41,29
"N00001002",648,49,44,24,20,30,4,45,132,79,26,67,125,96
"N00001003",174,9,9,7,2,9,0,9,46,42,5,14,25,15
"N00001004",243,16,16,8,8,8,0,16,54,33,10,27,46,33
"N00001005",198,19,17,11,6,12,1,18,31,25,6,21,41,26
"N00001006",484,42,10,6,4,329,1,41,33,25,8,9,20,8
"N00001007",550,71,28,16,12,268,5,66,54,44,17,17,29,22
"N00001008",236,23,6,4,2,153,2,21,13,13,2,7,13,6
"N00001009",174,21,4,2,2,79,2,19,24,14,3,6,16,7
"N00001010",316,9,7,6,1,225,1,8,24,20,2,2,20,7
"N00001011",337,13,13,9,4,246,1,12,13,9,2,7,25,9
"N00001012",335,33,14,13,1,180,0,33,32,17,7,17,22,13
"N00001013",220,10,10,8,2,108,0,10,19,25,6,9,23,10
"N00001014",225,15,5,4,1,148,0,15,16,17,2,6,7,9
"N00001015",388,20,7,6,1,263,0,20,27,28,6,16,15,6
"N00001016",260,39,3,3,0,130,1,38,24,19,3,12,15,15
"N00001017",296,23,17,14,3,173,3,20,25,16,6,9,19,8
"N00001018",264,52,10,8,2,101,0,52,51,18,6,7,9,10
"N00001019",189,8,10,10,0,125,0,8,13,8,1,8,7,9
"N00001020",153,10,8,7,1,50,1,9,12,17,6,10,22,18
"N00001021",219,10,9,7,2,140,1,9,15,12,1,8,17,7
"N00001022",582,45,30,16,14,266,3,42,72,45,16,18,58,32
"N00001023",210,17,6,4,2,113,0,17,21,18,1,7,19,8
"N00001024",340,25,14,8,6,161,3,22,42,43,7,17,22,9
"N00001025",273,9,19,14,5,170,0,9,21,15,4,6,17,12
"N00001026",226,19,15,8,7,112,0,19,22,15,5,11,16,11
"N00001027",318,33,30,22,8,38,4,29,45,54,7,14,47,50
"N00001028",195,9,39,31,8,16,3,6,20,17,8,14,33,39
"N00001029",444,16,77,59,18,81,4,12,57,50,9,30,77,47
"N00001030",410,19,72,56,16,81,2,17,42,38,7,23,65,63
"N00001031",301,20,23,14,9,79,1,19,39,33,8,21,39,39
"N00001032",142,10,16,11,5,14,2,8,11,14,6,6,33,32
"N00001033",118,2,18,11,7,3,1,1,6,11,8,11,22,37
"N00001034",247,17,9,4,5,27,5,12,61,38,10,21,36,28
"N00001035",196,1,44,33,11,16,0,1,10,17,5,12,49,42
"N00001036",275,23,21,11,10,22,6,17,43,26,10,20,52,58
"N00001037",243,59,11,10,1,32,8,51,69,28,16,8,13,7
"N00001038",530,80,21,12,9,48,15,65,165,74,30,19,51,42
"N00001039",255,51,10,9,1,27,9,42,79,32,17,8,16,15
"N00001040",171,3,12,7,5,10,0,3,19,25,12,18,38,34
"N00001041",134,2,11,7,4,2,0,2,9,15,5,14,38,38
"N00001042",484,71,27,19,8,39,8,63,115,73,27,19,67,46
"N00001043",158,3,20,14,6,8,0,3,9,10,8,14,42,44
"N00001044",216,10,12,6,6,10,3,7,31,31,16,15,48,43
"N00001045",214,20,6,2,4,19,5,15,41,41,8,18,37,24
"N00001046",218,38,1,1,0,36,7,31,61,28,10,14,19,11
"N00001047",230,33,4,3,1,12,8,25,48,49,19,13,31,21
"N00001048",221,30,13,7,6,23,5,25,71,30,11,6,23,14
"N00001049",230,24,5,4,1,20,1,23,46,32,14,30,40,19
"N00001050",241,30,3,2,1,29,5,25,74,35,11,12,37,10
"N00001051",272,55,5,3,2,40,7,48,73,37,28,8,17,9
"N00001052",143,7,17,10,7,9,1,6,22,12,6,12,36,22
"N00001053",275,50,9,6,3,45,6,44,86,32,31,2,15,5
"N00001054",249,52,6,2,4,35,4,48,76,36,17,5,14,8
"N00001055",252,41,13,9,4,33,8,33,84,27,18,5,23,8
"N00001056",267,17,11,4,7,27,4,13,63,39,19,19,45,27
"N00001057",240,24,8,7,1,18,3,21,58,41,12,23,32,24
"N00001058",247,61,4,2,2,35,11,50,73,20,21,10,15,8
"N00001059",223,27,12,7,5,28,3,24,58,37,11,8,32,10
"N00001060",186,15,4,3,1,19,1,14,42,36,6,18,23,23
"N00001061",186,45,2,1,1,14,9,36,57,35,12,7,9,5
"N00001062",201,42,5,4,1,16,8,34,64,22,12,13,19,8
"N00001063",221,51,3,2,1,17,11,40,74,35,18,5,16,2
"N00001064",439,110,13,10,3,27,16,94,160,63,24,11,24,7
"N00001065",216,46,2,2,0,21,9,37,93,14,17,9,9,5
"N00001066",210,28,8,4,4,24,4,24,60,34,15,14,15,12
"N00001067",186,30,2,0,2,13,9,21,65,34,13,7,16,6
"N00001068",233,53,8,3,5,11,6,47,72,43,16,6,12,12
"N00001069",243,37,3,2,1,15,5,32,73,44,22,11,26,12
"N00001070",361,65,4,2,2,29,6,59,131,47,19,15,32,19
"N00001071",232,45,8,1,7,15,9,36,67,30,14,11,28,14
"N00001072",210,25,6,2,4,25,1,24,54,31,10,16,30,13
"N00001073",216,5,15,11,4,17,1,4,32,26,7,20,57,37
"N00001074",163,36,1,0,1,14,8,28,53,25,11,3,14,6
"N00001075",209,27,10,6,4,15,1,26,32,33,9,12,42,29
"N00001076",181,15,10,5,5,11,2,13,47,25,8,12,27,26
"N00001077",170,9,15,9,6,7,3,6,24,30,5,12,39,29
"N00001078",194,34,4,2,2,11,1,33,58,38,8,14,14,13
"N00001079",633,29,85,56,29,55,2,27,96,80,21,48,128,91
"N00001080",241,13,21,13,8,16,1,12,57,38,8,16,49,23
"N00001081",304,21,23,15,8,26,5,16,49,52,18,24,50,41
"N00001082",340,21,34,20,14,38,1,20,58,38,21,21,66,43
"N00001083",317,43,21,14,7,39,6,37,89,38,24,14,31,18
"N00001084",303,25,28,23,5,36,2,23,62,47,21,23,36,25
"N00001085",798,86,75,53,22,80,9,77,174,117,45,44,110,67
"N00001086",252,37,8,6,2,22,8,29,71,37,12,19,26,20
"N00001087",214,24,9,5,4,28,8,16,51,36,8,10,24,24
"N00001088",214,25,6,3,3,15,8,17,66,42,11,8,23,18
"N00001089",227,12,25,19,6,21,3,9,41,28,9,12,40,39
"N00001090",148,2,12,10,2,11,0,2,21,17,5,12,33,35
"N00001091",300,18,16,10,6,42,2,16,68,47,36,16,37,20
"N00001092",292,13,43,33,10,43,4,9,49,33,19,20,41,31
"N00001093",369,9,85,65,20,39,1,8,28,37,17,20,75,59
"N00001094",166,1,36,24,12,4,0,1,18,14,10,12,38,33
"N00001095",254,20,25,18,7,24,3,17,33,34,10,20,52,36
"N00001096",311,18,11,8,3,44,4,14,85,40,28,18,42,25
"N00001097",239,6,19,11,8,22,3,3,38,42,13,20,48,31
"N00001098",224,16,11,10,1,21,4,12,50,29,17,15,38,27
"N00001099",214,14,13,4,9,13,5,9,41,31,10,12,42,38
"N00001100",229,17,18,8,10,19,3,14,37,44,15,13,36,30
"N00001101",215,18,9,4,5,14,2,16,33,29,20,19,45,28
"N00001102",390,14,56,36,20,37,2,12,26,41,8,26,88,94
"N00001103",144,3,31,24,7,11,0,3,10,13,5,11,33,27
"N00001104",209,12,23,16,7,14,0,12,31,26,12,18,35,38
"N00001105",201,11,26,20,6,22,0,11,33,29,12,12,27,29
"N00001106",202,8,45,35,10,16,2,6,24,18,6,12,30,43
"N00001107",220,6,36,30,6,24,0,6,15,31,8,13,46,41
"N00001108",143,4,27,20,7,8,2,2,18,20,4,8,29,25
"N00001109",269,5,51,43,8,32,0,5,30,28,7,19,42,55
"N00001110",231,7,36,26,10,21,1,6,20,26,6,18,50,47
"N00001111",462,9,76,64,12,55,1,8,47,58,15,28,93,81
"N00001112",214,7,47,35,12,24,1,6,13,29,4,14,40,36
"N00001113",1015,35,190,153,37,70,2,33,116,135,27,72,153,217
"N00001114",258,11,43,27,16,26,1,10,48,30,6,15,38,41
"N00001115",174,10,18,9,9,16,1,9,20,25,9,10,30,36
"N00001116",386,14,64,54,10,29,0,14,41,56,9,24,75,74
"N00001117",510,10,76,62,14,45,5,5,26,41,20,36,118,138
"N00001118",195,2,32,24,8,10,1,1,11,16,12,10,43,59
"N00001119",116,1,16,12,4,6,0,1,4,6,3,7,28,45
"N00001120",148,0,27,22,5,10,0,0,7,22,2,12,24,44
"N00001121",162,2,46,39,7,3,1,1,17,12,3,9,33,37
"N00001122",127,1,30,25,5,3,0,1,12,12,6,5,21,37
"N00001123",127,1,25,20,5,4,1,0,8,6,7,8,28,40
"N00001124",392,13,52,38,14,41,4,9,37,37,8,29,86,89
"N00001125",268,4,41,34,7,24,2,2,25,18,6,18,60,72
"N00001126",164,1,32,27,5,9,0,1,9,20,3,7,42,41
"N00001127",457,7,85,75,10,42,1,6,39,32,12,30,103,107
"N00001128",198,7,50,37,13,10,4,3,9,16,5,13,38,50
"N00001129",303,7,39,29,10,25,0,7,25,35,14,19,66,73
"N00001130",129,1,24,19,5,13,1,0,12,13,5,7,23,31
"N00001131",941,123,130,105,25,86,6,117,172,104,34,62,122,108
"N00001132",193,1,37,27,10,18,0,1,16,14,5,16,29,57
"N00001133",462,22,55,39,16,30,4,18,51,47,21,38,94,104
"N00001134",158,19,13,8,5,7,4,15,26,20,6,5,37,25
"N00001135",141,1,15,11,4,17,0,1,10,19,7,7,28,37
"N00001136",181,4,26,13,13,9,0,4,18,19,5,12,37,51
"N00001137",196,7,38,33,5,17,2,5,12,15,9,11,34,53
"N00001138",138,2,37,32,5,7,0,2,8,8,1,12,23,40
"N00001139",387,26,31,24,7,34,2,24,74,51,22,35,62,52
"N00001140",234,9,22,15,7,31,1,8,21,26,7,13,57,48
"N00001141",123,3,12,9,3,7,0,3,10,14,5,10,31,31
"N00001142",135,4,10,8,2,8,0,4,12,12,2,8,38,41
"N00001143",98,2,18,12,6,5,2,0,11,6,3,4,22,27
"N00001144",150,7,27,18,9,11,2,5,10,11,6,10,31,37
"N00001145",227,0,61,48,13,11,0,0,11,25,7,16,40,56
"N00001146",205,3,37,30,7,22,1,2,16,19,6,10,43,49
"N00001147",198,4,38,28,10,15,1,3,21,21,6,10,39,44
"N00001148",189,1,50,44,6,18,0,1,10,10,6,9,33,52
"N00001149",284,7,83,72,11,34,0,7,18,22,13,13,46,48
"N00001150",234,0,66,60,6,44,0,0,14,20,3,10,42,35
"N00001151",269,5,58,51,7,29,0,5,23,29,6,12,35,72
"N00001152",278,2,88,76,12,28,1,1,18,29,4,15,40,54
"N00001153",241,2,59,49,10,17,2,0,18,29,6,15,42,53
"N00001154",194,2,50,43,7,18,0,2,17,21,3,13,27,43
"N00001155",532,67,60,44,16,23,3,64,104,68,12,38,85,75
"N00001156",970,15,201,160,41,97,3,12,101,79,33,60,161,223
"N00001157",204,20,14,8,6,20,2,18,51,26,15,9,26,23
"N00001158",180,13,6,4,2,18,6,7,45,29,9,18,25,17
"N00001159",259,16,21,11,10,32,3,13,48,38,21,19,41,23
"N00001160",247,7,29,22,7,27,0,7,34,39,6,10,45,50
"N00001161",185,9,22,17,5,18,0,9,36,27,6,13,31,23
"N00001162",135,12,12,6,6,10,2,10,23,30,13,4,18,13
"N00001163",203,10,28,26,2,13,3,7,24,30,8,13,28,49
"N00001164",258,12,20,16,4,35,4,8,48,38,13,14,44,34
"N00001165",233,8,7,2,5,32,4,4,46,42,13,20,34,31
"N00001166",454,12,35,25,10,45,2,10,61,82,36,29,76,78
"N00001167",248,13,12,9,3,26,2,11,54,45,17,12,50,19
"N00001168",258,5,54,45,9,32,0,5,21,18,13,12,50,53
"N00001169",233,6,16,12,4,18,0,6,46,47,17,16,30,37
"N00001170",250,6,20,14,6,21,2,4,38,41,19,20,47,38
"N00001171",293,11,20,15,5,25,2,9,48,50,14,20,51,54
"N00001172",217,13,11,7,4,24,4,9,46,31,15,16,34,27
"N00001173",195,16,7,4,3,14,6,10,36,38,4,17,31,32
"N00001174",236,62,8,7,1,24,7,55,74,17,19,9,17,6
"N00001175",237,51,3,0,3,28,6,45,80,27,16,10,15,7
"N00001176",188,18,6,2,4,7,4,14,38,32,9,14,40,24
"N00001177",210,18,3,0,3,13,2,16,48,31,14,18,45,20
"N00001178",292,46,10,5,5,39,9,37,86,38,16,12,28,17
"N00001179",243,46,6,3,3,34,11,35,81,34,13,3,17,9
"N00001180",113,11,2,1,1,15,1,10,25,25,4,7,15,9
"N00001181",157,9,5,2,3,22,1,8,50,26,7,10,16,12
"N00001182",276,52,10,5,5,35,11,41,86,45,9,5,24,10
"N00001183",339,55,15,11,4,25,6,49,90,49,31,16,37,21
"N00001184",211,19,7,3,4,31,0,19,53,30,11,17,30,13
"N00001185",205,10,8,6,2,5,2,8,41,42,11,17,41,30
"N00001186",191,28,10,6,4,12,2,26,39,37,15,10,23,17
"N00001187",245,62,4,3,1,27,6,56,72,31,16,10,14,9
"N00001188",519,55,53,47,6,39,6,49,135,74,37,23,64,39
"N00001189",231,22,7,4,3,29,6,16,53,37,17,12,32,22
"N00001190",216,16,9,6,3,17,2,14,37,36,9,17,44,31
"N00001191",174,8,9,6,3,11,1,7,27,22,9,13,45,30
"N00001192",186,10,12,7,5,8,1,9,39,18,18,8,44,29
"N00001193",169,5,9,6,3,16,0,5,22,21,4,15,40,37
"N00001194",215,5,7,6,1,23,1,4,28,30,6,24,46,46
"N00001195",147,9,14,9,5,8,3,6,34,21,5,15,26,15
"N00001196",261,12,11,7,4,19,5,7,36,42,21,22,64,34
"N00001197",194,19,14,11,3,4,3,16,21,22,10,12,53,39
"N00001198",309,56,9,8,1,25,8,48,75,43,24,18,29,30
"N00001199",154,7,12,9,3,10,1,6,29,19,10,12,29,26
"N00001200",257,57,8,6,2,31,9,48,67,37,16,10,20,11
"N00001201",223,45,6,4,2,15,4,41,73,34,16,7,16,11
"N00001202",212,7,50,40,10,30,1,6,26,16,8,9,37,29
"N00001203",236,12,48,40,8,22,2,10,40,38,9,8,38,21
"N00001204",689,36,58,37,21,79,8,28,129,112,38,47,107,83
"N00001205",389,14,31,28,3,42,2,12,50,74,17,23,74,64
"N00001206",167,4,20,12,8,18,1,3,20,22,3,11,33,36
"N00001207",306,12,16,11,5,55,2,10,52,54,19,25,44,29
"N00001208",255,13,20,13,7,33,3,10,37,42,13,24,42,31
"N00001209",192,2,28,23,5,15,0,2,22,27,6,18,38,36
"N00001210",233,8,21,16,5,26,2,6,31,38,15,17,33,44
"N00001211",197,7,11,9,2,25,0,7,34,26,13,5,37,39
"N00001212",213,11,16,11,5,25,6,5,23,27,11,15,49,36
"N00001213",220,4,34,22,12,28,1,3,25,34,8,16,38,33
"N00001214",200,3,22,17,5,27,1,2,26,30,8,19,33,32
"N00001215",197,5,19,17,2,24,0,5,31,31,12,6,35,34
"N00001216",302,9,22,15,7,41,1,8,47,67,24,19,44,29
"N00001217",255,3,35,27,8,16,1,2,32,37,8,20,56,48
"N00001218",206,11,13,11,2,17,0,11,24,33,14,16,47,31
"N00001219",217,3,46,38,8,19,0,3,18,17,9,22,34,49
"N00001220",165,2,34,27,7,9,0,2,13,14,6,9,41,37
"N00001221",192,6,38,31,7,13,2,4,13,11,7,14,45,45
"N00001222",160,0,25,17,8,17,0,0,11,16,6,12,34,39
"N00001223",210,2,25,20,5,15,1,1,21,14,6,13,55,59
"N00001224",202,8,24,16,8,10,3,5,27,17,3,29,43,41
"N00001225",171,5,18,14,4,18,0,5,20,19,5,15,39,32
"N00001226",174,5,11,7,4,11,1,4,14,25,7,13,46,42
"N00001227",171,4,27,19,8,11,1,3,13,15,7,11,40,43
"N00001228",120,3,21,14,7,9,1,2,6,12,2,11,24,32
"N00001229",176,5,17,13,4,10,2,3,20,28,10,18,38,30
"N00001230",226,4,14,11,3,27,0,4,40,39,9,19,41,33
"N00001231",287,13,44,35,9,28,1,12,33,37,17,21,50,44
"N00001232",269,19,15,10,5,47,2,17,53,34,25,21,27,28
"N00001233",272,11,17,6,11,43,4,7,55,33,23,19,45,26
"N00001234",258,15,18,11,7,33,3,12,49,50,14,14,36,29
"N00001235",693,12,107,85,22,93,1,11,80,103,40,37,102,119
"N00001236",256,12,31,23,8,40,2,10,40,26,10,17,46,34
"N00001237",210,9,23,21,2,17,4,5,20,21,18,14,39,49
"N00001238",234,7,26,21,5,20,1,6,31,32,13,19,41,45
"N00001239",235,7,18,11,7,31,0,7,45,40,17,16,38,23
"N00001240",853,27,132,78,54,74,4,23,97,117,38,55,141,172
"N00001241",258,8,38,28,10,37,0,8,17,29,11,15,53,50
"N00001242",247,7,29,23,6,25,1,6,30,27,21,15,45,48
"N00001243",211,7,31,24,7,18,1,6,23,21,10,19,45,37
"N00001244",220,6,30,23,7,20,1,5,23,28,11,13,51,38
"N00001245",231,6,35,30,5,22,1,5,25,31,12,14,47,39
"N00001246",437,27,23,13,10,23,6,21,73,85,25,39,78,64
"N00001247",178,1,15,12,3,11,0,1,12,24,7,20,40,48
"N00001248",314,19,13,11,2,25,3,16,63,46,15,18,72,43
"N00001249",284,20,9,6,3,23,3,17,55,44,17,22,65,29
"N00001250",321,9,14,8,6,25,1,8,53,66,28,25,66,35
"N00001251",231,5,21,17,4,17,0,5,23,32,8,21,50,54
"N00001252",234,13,21,10,11,23,3,10,35,38,13,19,35,37
"N00001253",171,6,7,4,3,15,0,6,16,18,8,13,42,46
"N00001254",229,5,10,7,3,26,1,4,44,32,17,17,49,29
"N00001255",195,4,15,7,8,8,1,3,27,30,15,23,41,32
"N00001256",191,10,9,4,5,14,2,8,34,38,14,18,32,22
"N00001257",165,4,28,20,8,10,2,2,20,20,0,16,28,39
"N00001258",182,5,20,13,7,10,1,4,15,16,7,17,41,51
"N00001259",190,2,27,20,7,17,0,2,11,11,2,15,47,58
"N00001260",250,2,32,19,13,36,0,2,20,23,4,22,57,54
"N00001261",192,3,28,17,11,17,1,2,14,7,3,20,39,61
"N00001262",275,10,23,17,6,8,5,5,39,40,9,29,70,47
"N00001263",233,14,16,9,7,12,5,9,44,26,19,33,38,31
"N00001264",135,12,17,13,4,4,2,10,20,20,5,6,27,24
"N00001265",704,121,86,75,11,41,6,115,136,79,18,39,98,86
"N00001266",124,2,20,15,5,8,1,1,6,11,2,9,30,36
"N00001267",217,1,23,11,12,23,1,0,22,19,3,14,43,69
"N00001268",211,5,39,34,5,13,2,3,15,14,8,17,47,53
"N00001269",401,37,29,18,11,29,8,29,77,63,10,36,70,50
"N00001270",224,10,18,14,4,4,2,8,36,42,7,6,51,50
"N00001271",1112,116,63,50,13,71,13,103,241,149,52,85,183,152
"N00001272",164,9,3,3,0,7,2,7,37,24,7,13,39,25
"N00001273",179,8,12,9,3,8,3,5,38,21,3,16,41,32
"N00001274",159,8,15,8,7,12,2,6,18,28,5,14,35,24
"N00001275",151,6,10,10,0,4,2,4,10,22,7,14,39,39
"N00001276",139,9,9,4,5,16,2,7,14,20,13,9,23,26
"N00001277",186,35,5,3,2,15,6,29,53,27,14,10,21,6
"N00001278",219,39,10,6,4,16,5,34,61,28,18,18,14,15
"N00001279",121,0,10,3,7,10,0,0,17,10,10,12,27,25
"N00001280",148,5,10,8,2,8,2,3,18,19,10,9,39,30
"N00001281",214,45,4,2,2,29,4,41,75,18,16,7,11,9
"N00001282",236,47,10,4,6,26,10,37,66,36,18,7,14,12
"N00001283",232,46,6,4,2,18,19,27,76,37,7,13,21,8
"N00001284",274,42,9,5,4,30,8,34,66,40,19,13,30,25
"N00001285",246,26,7,5,2,10,7,19,67,52,19,15,28,22
"N00001286",249,14,6,6,0,21,5,9,42,54,11,23,47,31
"N00001287",206,23,3,2,1,15,3,20,53,36,14,13,28,21
"N00001288",219,18,2,2,0,23,5,13,42,54,5,17,34,24
"N00001289",217,16,3,3,0,17,2,14,54,33,14,14,44,22
"N00001290",251,15,2,0,2,25,1,14,60,56,10,21,37,25
"N00001291",256,19,12,6,6,27,3,16,49,46,15,20,36,32
"N00001292",629,64,30,21,9,89,5,59,162,103,52,26,65,38
"N00001293",283,23,3,1,2,41,6,17,63,54,19,11,34,35
"N00001294",256,14,15,9,6,34,1,13,45,48,18,14,33,35
"N00001295",263,11,11,6,5,29,2,9,45,50,12,29,45,31
"N00001296",208,9,25,17,8,14,4,5,31,21,13,21,45,29
"N00001297",295,15,15,11,4,38,3,12,56,40,16,23,52,40
"N00001298",272,10,37,27,10,22,2,8,30,23,13,22,55,60
"N00001299",231,9,16,10,6,23,0,9,25,29,15,19,47,48
"N00001300",232,7,13,8,5,22,1,6,48,35,20,19,36,32
"N00001301",308,14,20,16,4,39,2,12,53,46,17,18,61,40
"N00001302",475,10,95,71,24,75,2,8,42,46,16,23,90,78
"N00001303",254,6,42,33,9,25,2,4,30,34,12,16,45,44
"N00001304",225,7,14,8,6,22,2,5,44,36,21,23,31,27
"N00001305",230,9,18,17,1,29,3,6,41,41,13,11,32,36
"N00001306",160,8,30,20,10,7,2,6,16,20,0,16,32,31
"N00001307",243,6,42,30,12,27,1,5,25,31,10,15,50,37
"N00001308",342,20,26,21,5,23,4,16,57,55,22,17,66,56
"N00001309",256,6,50,36,14,23,1,5,33,29,13,14,51,37
"N00001310",665,37,56,31,25,74,4,33,94,96,42,51,122,93
"N00001311",197,1,34,29,5,28,0,1,12,22,6,14,44,36
"N00001312",423,19,57,43,14,54,2,17,45,41,13,25,94,75
"N00001313",309,16,27,16,11,11,2,14,62,41,18,22,54,58
"N00001314",278,10,44,33,11,27,2,8,40,34,14,17,50,42
"N00001315",189,11,13,12,1,13,3,8,24,20,6,17,45,40
"N00001316",236,8,26,16,10,8,0,8,27,29,5,28,50,55
"N00001317",207,5,7,4,3,16,1,4,21,27,9,21,49,52
"N00001318",216,18,15,12,3,16,2,16,26,38,10,20,31,42
"N00001319",205,14,12,5,7,18,3,11,38,40,10,13,30,30
"N00001320",189,11,6,4,2,22,5,6,22,30,14,15,43,26
"N00001321",206,9,11,3,8,27,1,8,32,38,12,13,28,36
"N00001322",197,8,28,23,5,13,2,6,34,24,7,15,34,34
"N00001323",228,13,29,24,5,17,3,10,33,26,15,17,35,43
"N00001324",170,12,7,6,1,17,2,10,40,24,10,15,25,20
"N00001325",955,285,18,16,2,112,28,257,300,98,62,8,41,31
"N00001326",273,96,5,2,3,34,6,90,74,25,18,5,14,2
"N00001327",223,69,4,4,0,23,5,64,64,21,27,4,8,3
"N00001328",708,222,17,14,3,87,21,201,205,53,61,11,30,22
"N00001329",216,48,5,3,2,35,5,43,56,29,13,5,17,8
"N00001330",234,73,6,3,3,30,6,67,62,17,29,5,8,4
"N00001331",201,59,7,3,4,24,5,54,54,14,20,6,12,5
"N00001332",165,21,11,6,5,15,1,20,46,16,5,12,25,14
"N00001333",239,79,1,0,1,35,10,69,79,20,13,7,3,2
"N00001334",254,64,8,2,6,42,5,59,68,35,11,4,11,11
"N00001335",175,42,7,1,6,8,5,37,55,24,6,10,16,7
"N00001336",203,72,6,3,3,25,5,67,63,18,9,2,6,2
"N00001337",220,69,4,0,4,32,4,65,57,24,20,5,6,3
"N00001338",212,20,13,13,0,27,4,16,40,30,10,8,25,39
"N00001339",249,8,26,22,4,16,0,8,39,41,6,21,50,42
"N00001340",530,46,37,20,17,43,7,39,94,89,27,35,81,78
"N00001341",262,21,12,6,6,39,6,15,45,44,24,16,36,25
"N00001342",295,31,14,12,2,42,10,21,70,52,15,19,30,22
"N00001343",230,12,6,5,1,23,1,11,76,38,20,14,21,20
"N00001344",260,24,13,4,9,37,5,19,71,39,7,15,33,21
"N00001345",194,21,8,2,6,15,3,18,51,45,10,10,17,17
"N00001346",603,121,8,3,5,70,8,113,198,77,30,25,50,24
"N00001347",402,66,14,7,7,30,6,60,104,71,29,25,42,21
"N00001348",223,34,11,9,2,18,6,28,65,34,24,13,17,7
"N00001349",184,35,4,3,1,16,5,30,51,28,13,7,21,9
"N00001350",665,13,173,144,29,51,4,9,55,53,20,31,116,153
"N00001351",275,3,58,43,15,33,0,3,19,27,10,19,46,60
"N00001352",248,24,32,26,6,10,2,22,28,38,7,15,47,47
"N00001353",236,8,54,44,10,22,1,7,18,27,6,14,39,48
"N00001354",577,12,146,128,18,39,3,9,48,56,14,29,95,138
"N00001355",221,11,52,39,13,15,3,8,15,28,2,14,43,41
"N00001356",212,7,46,39,7,20,1,6,18,15,8,12,39,47
"N00001357",119,0,36,28,8,6,0,0,13,9,5,5,22,23
"N00001358",236,4,56,44,12,11,1,3,25,23,9,21,51,36
"N00001359",206,11,35,30,5,17,4,7,23,23,9,14,39,35
"N00001360",185,7,36,34,2,13,0,7,18,19,7,6,43,36
"N00001361",206,3,42,32,10,29,1,2,17,15,7,17,45,31
"N00001362",227,4,51,48,3,21,1,3,10,17,8,18,42,56
"N00001363",192,15,13,9,4,10,5,10,45,36,13,19,26,15
"N00001364",410,40,13,8,5,21,3,37,95,63,37,37,56,48
"N00001365",282,47,5,4,1,18,12,35,70,37,22,24,30,29
"N00001366",179,24,2,0,2,12,4,20,48,28,16,13,20,16
"N00001367",270,22,25,20,5,20,5,17,34,28,12,23,57,49
"N00001368",211,32,4,0,4,13,5,27,62,25,16,15,24,20
"N00001369",270,31,5,4,1,12,1,30,55,47,20,25,49,26
"N00001370",249,32,5,2,3,25,2,30,66,32,15,22,33,19
"N00001371",222,29,5,3,2,21,8,21,61,39,11,21,19,16
"N00001372",413,48,9,6,3,29,5,43,95,81,36,30,45,40
"N00001373",214,19,7,3,4,13,2,17,52,35,21,14,31,22
"N00001374",209,17,2,1,1,22,4,13,50,41,14,12,29,22
"N00001375",240,18,7,3,4,17,3,15,47,42,11,19,46,33
"N00001376",146,6,7,5,2,11,0,6,30,25,4,16,21,26
"N00001377",198,20,3,3,0,19,5,15,47,37,16,12,23,21
"N00001378",187,25,6,5,1,6,3,22,47,28,18,11,32,14
"N00001379",188,14,8,7,1,11,5,9,37,30,10,11,41,26
"N00001380",288,82,26,20,6,35,8,74,72,31,14,1,16,11
"N00001381",328,95,9,5,4,20,8,87,98,34,15,11,24,22
"N00001382",240,60,2,2,0,33,7,53,78,26,12,7,19,3
"N00001383",203,55,6,2,4,26,10,45,65,17,14,4,12,4
"N00001384",205,29,3,1,2,18,7,22,68,17,16,17,27,10
"N00001385",265,76,9,3,6,25,9,67,80,23,14,12,19,7
"N00001386",430,61,30,17,13,27,3,58,114,56,17,27,56,42
"N00001387",219,32,9,6,3,15,3,29,55,26,5,12,39,26
"N00001388",171,18,7,3,4,12,2,16,37,30,7,19,23,18
"N00001389",151,17,9,9,0,5,5,12,43,31,5,8,18,15
"N00001390",214,42,5,2,3,21,5,37,53,34,16,15,19,9
"N00001391",230,37,6,3,3,18,10,27,66,41,16,13,23,10
"N00001392",217,39,13,9,4,14,0,39,43,27,7,21,23,30
"N00001393",229,55,5,4,1,12,4,51,71,33,7,11,21,14
"N00001394",210,38,6,3,3,13,3,35,62,32,10,8,23,18
"N00001395",192,38,2,1,1,7,8,30,51,28,15,11,21,19
"N00001396",561,146,17,10,7,25,10,136,148,90,21,26,51,37
"N00001397",135,20,1,0,1,4,3,17,38,22,8,7,16,19
"N00001398",198,24,7,6,1,7,2,22,60,37,5,19,23,16
"N00001399",639,221,25,17,8,46,20,201,180,71,41,4,30,21
"N00001400",234,76,3,3,0,20,12,64,79,16,14,8,9,9
"N00001401",694,186,28,14,14,56,4,182,164,83,38,32,69,38
"N00001402",532,153,10,4,6,55,11,142,151,55,25,29,42,12
"N00001403",310,61,10,8,2,45,9,52,79,35,23,15,24,18
"N00001404",504,123,50,38,12,44,16,107,128,56,28,14,37,24
"N00001405",167,23,10,7,3,13,3,20,31,22,3,15,27,23
"N00001406",154,23,7,3,4,4,0,23,36,18,8,9,31,18
"N00001407",204,42,13,12,1,19,2,40,52,23,10,10,14,21
"N00001408",371,109,8,5,3,33,9,100,122,55,15,8,8,13
"N00001409",202,50,2,1,1,16,5,45,64,21,16,7,18,8
"N00001410",201,42,10,6,4,14,7,35,71,23,6,9,15,11
"N00001411",214,51,5,4,1,16,4,47,64,21,16,10,24,7
"N00001412",111,17,5,4,1,14,2,15,26,16,8,5,14,6
"N00001413",194,40,5,4,1,21,6,34,65,26,11,8,12,6
"N00001414",186,38,8,2,6,18,3,35,63,22,8,5,18,6
"N00001415",201,6,50,46,4,28,1,5,14,16,9,10,30,38
"N00001416",792,219,79,65,14,47,8,211,152,89,20,47,83,56
"N00001417",206,7,47,40,7,11,2,5,12,12,3,18,42,54
"N00001418",549,72,87,75,12,53,3,69,101,60,23,25,54,74
"N00001419",196,26,35,27,8,8,3,23,35,25,9,13,21,24
"N00001420",176,6,23,18,5,13,0,6,22,20,4,15,35,38
"N00001421",1157,156,86,64,22,185,7,149,244,127,34,77,112,136
"N00001422",153,3,21,16,5,10,1,2,19,16,9,14,31,30
"N00001423",311,10,73,62,11,27,1,9,25,18,17,24,60,57
"N00001424",164,8,21,19,2,11,1,7,18,19,7,14,28,38
"N00001425",197,4,26,23,3,20,0,4,19,10,8,18,44,48
"N00001426",144,3,19,14,5,13,1,2,14,10,5,15,25,40
"N00001427",187,5,36,26,10,13,0,5,13,14,4,12,41,49
"N00001428",222,12,17,14,3,62,0,12,21,16,4,15,34,41
"N00001429",890,63,88,67,21,211,2,61,149,84,18,63,102,112
"N00001430",180,6,38,30,8,19,0,6,14,19,3,8,30,43
"N00001431",230,11,31,25,6,24,3,8,17,10,10,16,52,59
"N00001432",205,1,40,32,8,13,0,1,18,16,7,11,41,58
"N00001433",171,2,23,21,2,11,0,2,21,18,8,18,34,36
"N00001434",206,2,20,17,3,21,0,2,21,18,11,13,42,58
"N00001435",172,3,38,31,7,12,0,3,12,9,8,8,33,49
"N00001436",201,2,47,40,7,21,0,2,9,18,4,8,41,51
"N00001437",142,7,39,30,9,9,0,7,7,12,1,7,28,32
"N00001438",203,8,27,20,7,21,2,6,15,16,3,19,46,48
"N00001439",210,9,24,17,7,7,1,8,28,24,5,22,50,41
"N00001440",186,5,27,21,6,17,1,4,15,12,5,18,39,48
"N00001441",194,8,48,31,17,9,1,7,15,16,2,8,30,58
"N00001442",205,4,43,32,11,18,0,4,14,11,15,10,38,52
"N00001443",150,5,31,20,11,4,0,5,9,8,4,13,34,42
"N00001444",197,7,56,49,7,14,0,7,9,10,6,10,33,52
"N00001445",257,64,3,3,0,28,12,52,90,24,26,5,12,5
"N00001446",224,38,4,2,2,19,8,30,75,50,15,8,13,2
"N00001447",216,25,4,2,2,20,8,17,87,41,9,5,19,6
"N00001448",252,70,3,3,0,27,16,54,79,37,9,3,16,8
"N00001449",225,66,1,0,1,11,6,60,77,36,13,2,11,8
"N00001450",186,43,2,0,2,13,11,32,62,32,12,4,11,7
"N00001451",162,33,5,3,2,14,3,30,42,26,15,5,11,11
"N00001452",221,54,4,2,2,24,10,44,68,25,16,11,9,10
"N00001453",259,69,2,2,0,30,10,59,85,37,9,7,14,6
"N00001454",247,55,8,5,3,32,9,46,68,40,18,6,10,10
"N00001455",185,41,5,2,3,16,6,35,50,21,22,7,14,9
"N00001456",245,71,6,4,2,11,10,61,82,31,14,10,16,4
"N00001457",225,44,4,4,0,33,2,42,71,29,22,8,5,9
"N00001458",212,42,9,7,2,10,8,34,67,29,16,8,14,17
"N00001459",293,49,5,4,1,75,11,38,87,33,18,6,13,7
"N00001460",424,67,20,10,10,23,8,59,120,59,45,17,54,19
"N00001461",215,61,5,2,3,30,4,57,58,22,16,10,6,7
"N00001462",252,78,3,2,1,25,5,73,76,34,10,11,10,5
"N00001463",270,85,7,5,2,38,7,78,78,23,21,8,5,5
"N00001464",264,70,5,3,2,28,5,65,79,29,17,14,18,4
"N00001465",312,111,6,6,0,45,12,99,78,25,32,2,10,3
"N00001466",229,40,5,4,1,103,3,37,42,13,10,2,10,4
"N00001467",1426,55,15,14,1,1246,9,46,52,24,13,7,9,5
"N00001468",258,23,1,0,1,145,2,21,37,20,4,7,15,6
"N00001469",217,46,4,3,1,95,0,46,34,15,7,5,6,5
"N00001470",334,31,8,2,6,200,0,31,34,21,2,8,18,12
"N00001471",486,28,3,1,2,370,2,26,35,28,3,5,12,2
"N00001472",701,163,6,5,1,302,21,142,110,43,30,10,21,16
"N00001473",370,109,8,5,3,44,4,105,89,49,23,14,19,15
"N00001474",228,73,6,6,0,20,6,67,60,26,25,3,12,3
"N00001475",244,65,5,3,2,38,4,61,68,36,9,4,11,8
"N00001476",206,59,4,3,1,28,2,57,51,28,13,8,11,4
"N00001477",192,55,3,2,1,23,6,49,58,23,7,5,11,7
"N00001478",222,69,7,3,4,30,5,64,64,27,8,3,9,5
"N00001479",251,74,7,2,5,37,8,66,71,19,13,5,16,9
"N00001480",338,11,40,29,11,14,3,8,50,56,10,25,67,65
"N00001481",172,2,22,13,9,17,0,2,20,16,12,14,34,35
"N00001482",248,18,9,6,3,18,2,16,38,35,10,20,63,37
"N00001483",193,30,6,4,2,8,2,28,53,21,7,8,36,24
"N00001484",171,8,16,7,9,5,2,6,37,26,5,13,36,25
"N00001485",195,18,6,3,3,7,2,16,32,37,8,17,32,38
"N00001486",252,28,8,7,1,21,7,21,58,46,22,18,36,15
"N00001487",233,18,5,3,2,14,4,14,25,52,14,20,46,39
"N00001488",212,16,13,11,2,22,2,14,38,28,9,16,44,26
"N00001489",223,15,5,4,1,19,2,13,26,36,9,23,57,33
"N00001490",144,12,14,13,1,8,1,11,25,17,3,15,28,22
"N00001491",157,17,7,5,2,12,6,11,31,20,8,11,26,25
"N00001492",178,8,13,9,4,6,0,8,34,24,7,14,40,32
"N00001493",198,20,7,2,5,7,3,17,43,25,15,14,41,26
"N00001494",158,13,8,5,3,11,3,10,33,24,6,15,26,22
"N00001495",226,16,12,8,4,23,1,15,42,27,11,17,45,33
"N00001496",204,19,7,2,5,7,0,19,46,37,6,15,40,27
"N00001497",187,17,11,8,3,7,7,10,34,36,12,13,36,21
"N00001498",353,14,54,41,13,17,3,11,38,31,13,29,80,77
"N00001499",265,13,28,17,11,27,4,9,38,27,4,24,53,51
"N00001500",192,12,25,17,8,5,1,11,36,31,14,15,29,25
"N00001501",382,11,60,47,13,22,2,9,32,34,10,37,83,93
"N00001502",314,18,24,18,6,20,2,16,54,36,14,21,73,54
"N00001503",155,5,23,16,7,8,1,4,16,18,5,10,33,37
"N00001504",193,9,39,33,6,13,3,6,18,14,1,6,51,42
"N00001505",362,31,28,22,6,32,1,30,59,39,14,27,81,51
"N00001506",187,11,28,22,6,7,1,10,27,13,6,23,33,39
"N00001507",170,5,24,16,8,8,0,5,10,18,5,11,39,50
"N00001508",347,16,46,39,7,25,2,14,50,38,8,31,83,50
"N00001509",282,18,35,25,10,16,0,18,41,25,8,26,54,59
"N00001510",173,12,8,4,4,14,3,9,32,27,11,14,25,30
"N00001511",452,22,57,47,10,70,2,20,36,33,9,27,102,96
"N00001512",230,20,14,6,8,20,2,18,46,25,3,16,50,36
"N00001513",179,9,16,12,4,9,0,9,25,14,7,15,43,41
"N00001514",170,37,9,5,4,15,8,29,42,15,13,3,27,9
"N00001515",231,56,9,6,3,28,5,51,59,26,24,6,13,10
"N00001516",148,43,4,3,1,16,6,37,50,18,9,1,6,1
"N00001517",248,86,5,4,1,19,7,79,69,31,20,2,13,3
"N00001518",336,94,11,9,2,28,18,76,96,33,43,9,12,10
"N00001519",209,9,23,17,6,24,1,8,34,26,5,14,36,38
"N00001520",183,4,21,14,7,19,3,1,16,15,4,16,42,46
"N00001521",174,3,26,20,6,6,1,2,20,19,4,14,30,52
"N00001522",213,17,13,8,5,31,4,13,43,36,5,18,28,22
"N00001523",145,6,16,15,1,17,0,6,8,17,5,13,24,39
"N00001524",180,5,26,20,6,16,0,5,18,16,7,7,38,47
"N00001525",153,9,8,6,2,8,1,8,35,23,7,9,30,24
"N00001526",157,7,15,11,4,15,0,7,29,19,3,13,21,35
"N00001527",166,26,11,10,1,16,3,23,35,15,11,5,22,25
"N00001528",196,49,5,5,0,17,7,42,59,23,8,10,15,10
"N00001529",210,19,11,9,2,21,2,17,43,40,7,14,29,26
"N00001530",273,64,7,1,6,31,7,57,100,32,12,8,12,7
"N00001531",217,4,54,48,6,23,0,4,16,13,4,9,45,49
"N00001532",318,17,28,20,8,36,4,13,32,48,29,26,43,59
"N00001533",486,5,102,90,12,45,2,3,47,49,21,24,86,107
"N00001534",250,4,62,43,19,28,0,4,21,19,4,12,49,51
"N00001535",257,4,70,61,9,38,1,3,11,21,6,8,40,59
"N00001536",281,8,42,34,8,32,1,7,31,39,14,21,42,52
"N00001537",249,1,68,58,10,23,1,0,13,17,7,22,41,57
"N00001538",289,8,30,23,7,36,4,4,33,46,14,18,49,55
"N00001539",236,4,48,36,12,32,1,3,26,21,5,14,38,48
"N00001540",311,6,74,62,12,38,2,4,29,33,18,12,48,53
"N00001541",203,2,47,40,7,26,1,1,8,12,4,13,45,46
"N00001542",237,1,63,53,10,25,1,0,19,14,4,11,40,60
"N00001543",243,3,69,61,8,30,1,2,18,26,6,17,37,37
"N00001544",216,8,37,29,8,28,0,8,17,18,5,16,40,47
"N00001545",258,12,35,27,8,18,3,9,42,41,10,22,37,41
"N00001546",251,8,53,40,13,46,3,5,25,22,4,12,44,37
"N00001547",248,17,33,26,7,20,1,16,35,37,10,11,45,40
"N00001548",254,6,63,37,26,12,2,4,28,22,11,14,48,50
"N00001549",270,5,53,41,12,32,0,5,22,28,7,18,55,50
"N00001550",166,3,26,16,10,10,0,3,18,14,5,15,37,38
"N00001551",293,11,43,29,14,44,2,9,39,25,21,16,51,43
"N00001552",284,10,36,33,3,39,0,10,31,42,16,18,57,35
"N00001553",209,7,39,25,14,14,1,6,24,18,6,13,43,45
"N00001554",245,7,36,32,4,20,2,5,36,34,14,19,47,32
"N00001555",186,0,48,40,8,14,0,0,10,12,6,9,42,45
"N00001556",157,8,17,11,6,19,2,6,19,26,10,16,27,15
"N00001557",174,4,45,40,5,25,0,4,5,9,10,6,42,28
"N00001558",179,13,28,21,7,18,0,13,21,20,9,13,28,29
"N00001559",260,17,37,22,15,12,2,15,40,40,14,24,36,40
"N00001560",194,8,33,25,8,19,4,4,30,30,7,17,32,18
"N00001561",176,11,21,16,5,17,1,10,32,22,4,13,37,19
"N00001562",166,4,32,16,16,13,1,3,26,19,4,10,29,29
"N00001563",101,2,18,11,7,6,0,2,12,3,6,9,18,27
"N00001564",239,9,32,21,11,25,1,8,31,24,13,18,38,49
"N00001565",266,7,82,62,20,30,0,7,16,18,7,8,41,57
"N00001566",267,4,45,35,10,36,0,4,12,43,4,16,44,63
"N00001567",171,5,22,19,3,24,2,3,21,25,3,5,29,37
"N00001568",187,6,23,16,7,22,1,5,22,32,6,14,38,24
"N00001569",245,5,50,34,16,10,0,5,30,36,13,18,40,43
"N00001570",701,13,171,155,16,91,4,9,46,81,7,36,134,122
"N00001571",300,2,79,72,7,36,0,2,19,21,3,15,56,69
"N00001572",243,3,63,55,8,38,2,1,13,18,8,10,50,40
"N00001573",287,4,89,78,11,33,0,4,20,14,5,17,56,49
"N00001574",220,5,55,50,5,23,1,4,16,23,6,12,34,46
"N00001575",220,3,54,48,6,21,1,2,20,17,6,6,54,39
"N00001576",280,6,44,39,5,45,1,5,16,23,9,8,58,71
"N00001577",245,3,55,42,13,31,0,3,17,31,5,12,37,54
"N00001578",231,4,68,60,8,25,1,3,16,17,8,6,37,50
"N00001579",266,44,8,5,3,88,2,42,41,36,6,10,25,8
"N00001580",265,77,10,6,4,58,5,72,62,22,9,4,15,8
"N00001581",200,55,11,5,6,27,1,54,61,16,19,3,8,0
"N00001582",201,59,7,1,6,30,2,57,51,18,12,4,13,7
"N00001583",219,29,5,1,4,47,2,27,47,33,10,16,20,12
"N00001584",163,18,13,6,7,25,3,15,36,19,9,10,15,18
"N00001585",426,31,6,4,2,266,0,31,42,19,4,21,23,14
"N00001586",207,46,8,7,1,56,1,45,48,15,5,10,16,3
"N00001587",297,43,8,3,5,101,1,42,55,33,8,14,26,9
"N00001588",253,24,14,9,5,83,4,20,52,21,4,11,25,19
"N00001589",265,47,5,4,1,95,2,45,39,28,9,14,18,10
"N00001590",325,60,5,3,2,144,2,58,40,35,6,13,17,5
"N00001591",264,25,6,3,3,139,2,23,33,18,2,9,23,9
"N00001592",244,26,15,11,4,85,0,26,26,17,3,16,28,28
"N00001593",479,51,18,17,1,225,1,50,66,32,10,22,38,17
"N00001594",333,25,18,14,4,169,1,24,34,24,4,13,27,19
"N00001595",263,18,13,10,3,138,0,18,31,14,7,8,23,11
"N00001596",370,23,13,8,5,238,0,23,26,23,3,7,30,7
"N00001597",239,19,13,9,4,99,0,19,36,19,4,12,25,12
"N00001598",345,18,9,7,2,197,0,18,34,30,3,11,25,18
"N00001599",418,25,25,19,6,244,0,25,37,24,4,11,31,17
"N00001600",273,17,14,9,5,115,1,16,40,30,7,16,25,9
"N00001601",252,33,10,9,1,107,1,32,38,24,6,9,18,7
"N00001602",291,32,10,5,5,123,1,31,37,29,8,11,25,16
"N00001603",275,18,16,11,5,112,1,17,32,28,2,26,24,17
"N00001604",230,22,18,11,7,12,1,21,32,19,9,18,48,52
"N00001605",219,11,18,8,10,11,0,11,24,39,11,16,39,50
"N00001606",163,20,13,6,7,9,4,16,36,22,3,10,22,28
"N00001607",216,12,26,16,10,12,0,12,38,29,9,19,35,36
"N00001608",188,18,19,9,10,7,0,18,37,13,9,14,48,23
"N00001609",193,11,12,9,3,9,3,8,43,34,8,18,32,26
"N00001610",185,30,23,14,9,10,0,30,43,25,4,9,20,21
"N00001611",206,7,32,21,11,11,2,5,22,18,6,14,52,44
"N00001612",186,3,33,23,10,18,0,3,8,20,12,14,42,36
"N00001613",519,35,52,41,11,40,3,32,67,60,20,38,97,110
"N00001614",195,9,27,17,10,14,0,9,21,27,6,17,40,34
"N00001615",216,11,16,11,5,11,0,11,41,22,12,25,39,39
"N00001616",221,9,29,22,7,16,1,8,34,21,6,18,45,43
"N00001617",214,33,8,6,2,10,5,28,45,33,16,5,33,31
"N00001618",182,11,20,15,5,21,1,10,27,17,7,14,28,37
"N00001619",200,9,15,8,7,7,2,7,17,30,12,14,39,57
"N00001620",254,11,30,21,9,23,0,11,35,31,6,23,48,47
"N00001621",187,6,21,11,10,13,2,4,32,21,15,10,34,35
"N00001622",193,14,11,7,4,25,1,13,30,24,7,14,33,35
"N00001623",194,4,43,29,14,12,1,3,17,24,8,20,35,31
"N00001624",115,1,18,11,7,3,0,1,4,11,6,6,35,31
"N00001625",175,8,26,20,6,11,1,7,19,24,11,11,29,36
"N00001626",181,1,17,11,6,9,0,1,22,27,3,23,37,42
"N00001627",120,3,11,8,3,10,1,2,10,16,2,7,32,29
"N00001628",180,6,21,19,2,16,2,4,17,24,4,16,40,36
"N00001629",195,5,15,10,5,10,0,5,22,24,6,11,48,54
"N00001630",153,1,29,17,12,12,1,0,12,14,7,7,35,36
"N00001631",158,2,15,11,4,18,1,1,11,17,6,10,38,41
"N00001632",173,4,22,11,11,15,1,3,14,11,10,16,42,39
"N00001633",138,1,22,12,10,7,1,0,17,16,7,13,29,26
"N00001634",170,4,24,16,8,9,0,4,17,11,3,16,30,56
"N00001635",202,3,19,16,3,15,1,2,21,21,6,17,47,53
"N00001636",120,4,13,12,1,7,0,4,20,7,3,6,33,27
"N00001637",168,4,29,23,6,13,1,3,8,13,5,9,43,44
"N00001638",184,4,35,24,11,6,1,3,5,18,5,10,46,55
"N00001639",137,3,32,27,5,7,1,2,9,8,1,11,28,38
"N00001640",156,0,24,18,6,10,0,0,17,10,1,11,34,49
"N00001641",185,10,19,10,9,10,2,8,23,26,6,17,44,30
"N00001642",237,42,3,0,3,20,12,30,82,33,24,14,8,11
"N00001643",397,35,18,10,8,28,8,27,102,70,21,31,64,28
"N00001644",253,26,8,6,2,29,6,20,66,36,15,17,36,20
"N00001645",179,6,14,10,4,16,2,4,25,25,13,19,37,24
"N00001646",210,26,13,6,7,5,4,22,53,31,12,17,33,20
"N00001647",212,16,10,8,2,16,2,14,37,49,8,8,35,33
"N00001648",248,13,6,2,4,14,2,11,54,56,13,28,41,23
"N00001649",326,40,3,1,2,51,7,33,98,54,12,17,33,18
"N00001650",222,9,5,3,2,15,2,7,45,45,12,19,48,24
"N00001651",276,25,4,2,2,29,7,18,62,61,24,17,45,9
"N00001652",301,40,5,2,3,43,12,28,76,56,21,18,26,16
"N00001653",317,25,2,2,0,46,11,14,79,60,18,19,44,24
"N00001654",288,21,5,3,2,25,6,15,47,57,21,30,51,31
"N00001655",284,24,14,7,7,17,2,22,65,47,26,30,38,23
"N00001656",161,9,2,2,0,10,2,7,44,29,11,15,21,20
"N00001657",203,25,6,5,1,12,4,21,45,39,24,16,23,13
"N00001658",131,11,5,2,3,5,3,8,39,18,9,8,20,16
"N00001659",186,10,4,1,3,10,3,7,52,43,4,15,29,19
"N00001660",229,33,9,3,6,19,3,30,71,38,15,9,20,15
"N00001661",264,23,7,1,6,18,4,19,68,40,14,26,48,20
"N00001662",258,16,10,8,2,23,8,8,53,51,19,24,42,20
"N00001663",263,10,7,5,2,22,4,6,53,43,14,32,47,35
"N00001664",251,26,7,3,4,33,8,18,38,48,11,19,36,33
"N00001665",272,22,8,4,4,22,3,19,62,44,19,25,42,28
"N00001666",290,32,4,3,1,37,10,22,63,57,9,20,43,25
"N00001667",227,17,2,1,1,28,3,14,42,40,12,25,39,22
"N00001668",288,26,9,3,6,27,9,17,56,57,16,28,43,26
"N00001669",268,29,10,6,4,30,9,20,63,42,25,14,37,18
"N00001670",185,5,19,9,10,13,3,2,22,18,11,19,45,33
"N00001671",209,3,17,6,11,22,2,1,17,28,4,16,50,52
"N00001672",239,10,19,11,8,10,1,9,28,41,13,29,51,38
"N00001673",337,21,11,5,6,35,5,16,54,51,22,33,57,53
"N00001674",176,4,16,6,10,6,0,4,20,29,7,19,43,32
"N00001675",205,3,10,6,4,20,0,3,27,26,9,18,50,42
"N00001676",193,4,23,14,9,17,1,3,9,25,8,15,51,41
"N00001677",392,42,2,0,2,40,16,26,86,78,33,38,53,20
"N00001678",339,33,11,6,5,41,6,27,73,49,46,27,35,24
"N00001679",290,26,7,2,5,26,6,20,61,58,22,30,39,21
"N00001680",357,48,6,3,3,29,13,35,93,63,25,36,37,20
"N00001681",228,15,18,10,8,9,2,13,45,23,18,20,48,32
"N00001682",243,15,9,4,5,24,3,12,44,41,12,19,52,27
"N00001683",274,10,33,29,4,21,2,8,35,40,16,30,43,46
"N00001684",625,50,15,12,3,65,16,34,170,118,58,40,65,44
"N00001685",268,12,6,4,2,42,2,10,52,53,19,22,37,25
"N00001686",209,9,14,7,7,16,3,6,42,36,14,19,30,29
"N00001687",246,27,4,1,3,34,6,21,44,51,9,21,36,20
"N00001688",251,8,15,10,5,20,1,7,32,30,11,21,55,59
"N00001689",186,7,14,7,7,4,1,6,26,23,5,16,49,42
"N00001690",257,25,14,5,9,28,7,18,56,39,22,18,23,32
"N00001691",212,4,25,14,11,12,1,3,24,32,10,18,40,47
"N00001692",189,3,18,9,9,10,0,3,21,22,8,24,36,47
"N00001693",202,38,3,2,1,15,6,32,58,26,23,10,15,14
"N00001694",221,19,8,2,6,33,5,14,57,37,16,15,22,14
"N00001695",303,33,8,5,3,42,4,29,81,58,28,14,24,15
"N00001696",281,31,6,3,3,19,5,26,73,47,30,21,27,27
"N00001697",229,25,8,6,2,16,4,21,40,29,24,19,35,33
"N00001698",205,13,9,1,8,22,2,11,42,27,14,10,34,34
"N00001699",312,65,7,6,1,28,5,60,94,45,20,19,20,14
"N00001700",194,5,7,3,4,10,0,5,32,32,11,14,41,42
"N00001701",153,5,13,9,4,9,2,3,22,25,4,17,29,29
"N00001702",259,17,13,7,6,24,4,13,55,42,17,19,42,30
"N00001703",815,59,88,64,24,34,14,45,157,112,56,64,129,116
"N00001704",586,50,79,53,26,24,9,41,114,75,34,43,97,70
"N00001705",160,3,11,6,5,12,0,3,25,16,13,15,29,36
"N00001706",334,48,8,3,5,37,11,37,99,62,21,16,31,12
"N00001707",280,31,9,3,6,33,6,25,86,41,13,14,39,14
"N00001708",451,73,13,7,6,31,12,61,153,73,24,17,40,27
"N00001709",184,10,8,4,4,13,2,8,28,28,10,17,46,24
"N00001710",255,50,2,2,0,20,6,44,88,34,25,4,25,7
"N00001711",265,47,12,5,7,24,11,36,81,37,24,9,22,9
"N00001712",261,9,31,18,13,13,3,6,35,35,12,28,44,54
"N00001713",141,9,15,12,3,6,2,7,22,18,6,11,27,27
"N00001714",398,9,24,9,15,19,3,6,48,39,19,45,123,72
"N00001715",198,4,33,17,16,9,0,4,19,19,11,16,49,38
"N00001716",239,21,3,3,0,10,4,17,64,50,7,29,30,25
"N00001717",274,16,12,7,5,10,1,15,50,53,15,30,48,40
"N00001718",225,11,8,6,2,11,1,10,33,40,29,23,38,32
"N00001719",217,4,20,10,10,14,3,1,24,35,7,18,46,49
"N00001720",228,9,15,9,6,11,3,6,44,29,15,17,45,43
"N00001721",208,2,20,13,7,13,0,2,20,33,10,22,48,40
"N00001722",227,3,30,20,10,8,1,2,23,35,12,20,41,55
"N00001723",200,3,15,8,7,9,0,3,22,25,11,18,43,54
"N00001724",167,5,18,12,6,13,3,2,19,23,3,19,38,29
"N00001725",189,6,15,9,6,12,3,3,20,13,14,17,49,43
"N00001726",196,4,9,5,4,17,1,3,20,26,9,22,51,38
"N00001727",156,3,14,12,2,4,1,2,16,20,7,14,37,41
"N00001728",220,4,27,11,16,13,1,3,26,22,15,26,37,50
"N00001729",216,5,20,8,12,18,2,3,34,23,5,19,54,38
"N00001730",171,8,11,8,3,9,3,5,29,25,9,16,34,30
"N00001731",169,6,19,11,8,8,0,6,18,22,8,12,45,31
"N00001732",850,69,19,7,12,123,19,50,233,138,41,58,105,64
"N00001733",197,7,13,9,4,19,1,6,23,25,10,22,40,38
"N00001734",219,9,10,6,4,21,3,6,37,28,9,19,51,35
"N00001735",176,8,10,6,4,18,2,6,29,22,12,27,28,22
"N00001736",212,15,29,24,5,3,2,13,39,23,15,22,35,31
"N00001737",263,13,13,4,9,28,2,11,44,45,11,26,46,37
"N00001738",247,43,10,4,6,25,6,37,82,40,20,7,12,8
"N00001739",262,31,7,5,2,14,4,27,73,32,33,11,38,23
"N00001740",478,46,22,13,9,37,14,32,113,80,28,35,72,45
"N00001741",196,22,7,6,1,26,5,17,55,31,13,8,20,14
"N00001742",167,8,13,5,8,12,1,7,34,22,9,19,27,23
"N00001743",206,25,7,5,2,18,2,23,45,30,21,17,25,18
"N00001744",255,30,9,7,2,27,6,24,54,45,23,17,34,16
"N00001745",242,18,1,1,0,37,4,14,40,57,20,15,38,16
"N00001746",239,17,5,2,3,20,3,14,43,46,17,23,40,28
"N00001747",526,27,21,9,12,44,5,22,94,89,42,53,80,76
"N00001748",342,27,10,8,2,34,8,19,73,55,55,16,52,20
"N00001749",255,26,9,6,3,26,4,22,47,34,37,23,34,19
"N00001750",207,15,9,6,3,20,4,11,54,43,18,9,28,11
"N00001751",225,25,8,8,0,20,5,20,71,38,17,11,26,9
"N00001752",219,29,2,2,0,15,5,24,49,47,15,8,38,16
"N00001753",241,22,16,8,8,19,8,14,39,34,22,16,36,37
"N00001754",269,35,5,4,1,29,9,26,66,47,23,17,29,18
"N00001755",278,50,6,4,2,28,10,40,79,39,47,6,12,11
"N00001756",261,39,6,2,4,23,10,29,70,40,31,16,21,15
"N00001757",183,19,2,1,1,5,1,18,53,46,12,6,24,16
"N00001758",216,15,1,1,0,19,4,11,60,45,6,10,40,20
"N00001759",228,18,3,2,1,26,4,14,63,40,21,16,28,13
"N00001760",943,160,111,102,9,79,22,138,251,108,55,42,79,58
"N00001761",299,82,7,7,0,48,8,74,80,26,27,6,19,4
"N00001762",189,11,10,8,2,11,1,10,27,34,15,15,38,28
"N00001763",1020,185,34,20,14,106,33,152,283,135,54,42,122,59
"N00001764",168,8,17,15,2,12,2,6,23,23,7,14,34,30
"N00001765",734,110,46,28,18,56,17,93,193,106,39,35,92,57
"N00001766",189,6,13,9,4,13,0,6,32,41,8,19,33,24
"N00001767",232,35,6,4,2,18,8,27,74,40,12,15,19,13
"N00001768",223,39,4,4,0,25,9,30,53,43,12,12,25,10
"N00001769",280,52,6,4,2,38,10,42,72,52,19,11,15,15
"N00001770",213,58,3,2,1,34,11,47,59,28,9,7,10,5
"N00001771",308,67,11,9,2,46,15,52,86,36,19,15,13,15
"N00001772",220,36,4,3,1,20,8,28,56,43,11,15,28,7
"N00001773",214,29,11,11,0,17,5,24,57,42,14,14,22,8
"N00001774",239,40,4,3,1,30,5,35,57,47,13,14,26,8
"N00001775",227,45,3,2,1,16,2,43,71,37,11,9,21,14
"N00001776",217,31,3,0,3,19,6,25,62,32,20,9,20,21
"N00001777",253,45,2,1,1,16,4,41,74,53,17,15,19,12
"N00001778",234,23,2,2,0,21,4,19,58,49,19,22,30,10
"N00001779",216,9,18,9,9,18,2,7,24,19,11,21,45,51
"N00001780",463,60,5,2,3,34,8,52,141,95,45,18,39,26
"N00001781",282,44,5,2,3,27,13,31,73,61,18,13,27,14
"N00001782",258,26,4,3,1,24,8,18,61,56,20,25,22,20
"N00001783",273,29,5,2,3,21,6,23,60,53,18,25,35,27
"N00001784",207,10,17,11,6,11,3,7,35,25,9,20,42,38
"N00001785",255,4,18,9,9,16,1,3,22,39,10,32,57,57
"N00001786",241,19,16,13,3,15,5,14,41,45,14,19,43,29
"N00001787",205,3,19,13,6,10,1,2,14,31,8,21,47,52
"N00001788",236,4,10,9,1,23,1,3,25,26,5,25,58,60
"N00001789",306,44,4,4,0,24,6,38,77,53,18,20,44,22
"N00001790",258,38,35,32,3,19,7,31,61,36,28,8,22,11
"N00001791",357,51,7,5,2,62,8,43,103,47,29,12,35,11
"N00001792",266,44,7,5,2,52,8,36,92,32,13,9,12,5
"N00001793",326,48,6,4,2,51,6,42,103,44,21,15,30,8
"N00001794",589,49,22,14,8,37,12,37,127,121,34,41,95,63
"N00001795",224,20,6,2,4,20,1,19,71,39,7,16,24,21
"N00001796",230,28,5,2,3,34,5,23,68,31,19,9,26,10
"N00001797",226,41,7,6,1,17,6,35,61,39,14,11,23,13
"N00001798",304,61,7,6,1,43,10,51,76,52,22,12,21,10
"N00001799",230,36,3,3,0,15,6,30,64,37,36,9,18,12
"N00001800",275,34,5,2,3,29,7,27,68,44,10,22,35,28
"N00001801",301,60,5,2,3,37,7,53,87,42,19,15,23,13
"N00001802",247,35,5,4,1,20,1,34,70,42,12,13,30,20
"N00001803",225,22,13,5,8,19,6,16,47,37,16,22,25,24
"N00001804",265,35,7,5,2,37,5,30,76,49,21,13,16,11
"N00001805",643,98,26,14,12,43,13,85,183,107,43,32,76,35
"N00001806",236,8,12,9,3,19,3,5,31,25,14,19,59,49
"N00001807",179,21,8,7,1,11,5,16,37,30,14,10,27,21
"N00001808",175,7,13,8,5,10,1,6,16,20,5,21,49,34
"N00001809",182,6,6,2,4,20,3,3,22,21,10,13,52,32
"N00001810",143,5,12,7,5,15,2,3,23,20,6,10,25,27
"N00001811",179,10,12,8,4,20,0,10,16,20,8,13,41,39
"N00001812",270,13,34,20,14,8,1,12,21,40,17,23,64,50
"N00001813",113,3,5,3,2,2,0,3,14,25,6,12,19,27
"N00001814",483,27,16,6,10,30,5,22,115,71,28,46,106,44
"N00001815",240,15,8,5,3,21,1,14,43,50,19,13,45,26
"N00001816",346,18,11,5,6,27,5,13,63,65,21,36,64,41
"N00001817",211,15,5,3,2,15,5,10,56,44,20,12,32,12
"N00001818",189,11,2,2,0,15,1,10,27,35,12,19,37,31
"N00001819",252,15,8,5,3,26,2,13,55,52,14,19,37,26
"N00001820",200,19,8,5,3,10,4,15,51,31,13,13,34,21
"N00001821",471,52,13,9,4,32,4,48,132,77,32,37,66,30
"N00001822",200,21,10,3,7,7,2,19,43,52,12,10,20,25
"N00001823",277,24,3,2,1,14,2,22,79,61,9,16,47,24
"N00001824",262,31,5,3,2,27,12,19,64,51,25,16,29,14
"N00001825",175,15,8,6,2,18,4,11,38,29,8,21,20,18
"N00001826",250,32,3,1,2,28,5,27,57,63,25,12,18,12
"N00001827",232,20,4,3,1,23,6,14,54,41,15,15,41,19
"N00001828",176,12,7,5,2,6,2,10,39,36,4,21,37,14
"N00001829",165,15,3,0,3,16,3,12,42,23,7,17,25,17
"N00001830",285,9,17,9,8,36,3,6,29,39,11,21,64,59
"N00001831",258,30,5,5,0,35,6,24,69,50,19,18,25,7
"N00001832",176,7,9,5,4,9,1,6,14,23,10,21,47,36
"N00001833",249,8,23,10,13,15,0,8,24,41,13,19,66,40
"N00001834",180,9,7,2,5,16,3,6,13,32,5,15,40,43
"N00001835",217,2,14,13,1,18,1,1,30,32,9,22,52,38
"N00001836",206,7,12,6,6,22,0,7,27,27,12,14,49,36
"N00001837",163,3,11,10,1,4,0,3,27,30,14,11,28,35
"N00001838",193,4,15,8,7,13,1,3,17,23,8,24,53,36
"N00001839",275,38,13,9,4,16,4,34,96,42,15,15,32,8
"N00001840",271,52,6,1,5,45,2,50,90,38,8,4,19,9
"N00001841",261,46,9,8,1,16,6,40,76,44,20,12,25,13
"N00001842",182,44,3,2,1,5,7,37,56,25,12,11,22,4
"N00001843",254,42,1,0,1,28,5,37,91,34,11,17,21,9
"N00001844",230,42,9,9,0,13,7,35,63,42,8,11,25,17
"N00001845",201,30,3,3,0,16,2,28,56,36,7,19,27,7
"N00001846",215,28,6,4,2,13,3,25,62,38,15,10,27,16
"N00001847",207,28,6,3,3,19,4,24,69,36,13,15,14,7
"N00001848",215,36,2,2,0,29,8,28,69,31,12,12,23,1
"N00001849",200,15,4,4,0,17,5,10,55,34,14,12,29,20
"N00001850",436,60,12,6,6,37,4,56,133,73,38,19,42,22
"N00001851",197,26,3,1,2,17,5,21,61,42,16,10,16,6
"N00001852",208,43,8,6,2,17,8,35,67,37,11,6,17,2
"N00001853",228,40,3,1,2,26,9,31,64,34,22,11,19,9
"N00001854",179,3,13,7,6,9,1,2,21,26,14,12,48,33
"N00001855",216,10,4,3,1,20,1,9,46,39,18,17,35,27
"N00001856",195,12,11,8,3,15,5,7,41,30,13,15,32,26
"N00001857",194,9,8,3,5,8,0,9,37,30,19,19,39,25
"N00001858",166,6,3,2,1,9,2,4,17,27,17,10,45,32
"N00001859",199,9,15,7,8,12,4,5,28,25,13,15,52,30
"N00001860",148,5,12,7,5,10,0,5,20,20,11,15,24,31
"N00001861",185,7,17,7,10,16,1,6,23,31,10,12,37,32
"N00001862",263,21,13,8,5,22,6,15,57,41,16,22,47,24
"N00001863",183,18,7,5,2,9,2,16,45,30,14,11,31,18
"N00001864",251,42,9,7,2,24,4,38,79,41,20,8,22,6
"N00001865",368,74,6,4,2,28,11,63,113,84,13,7,31,12
"N00001866",181,41,4,3,1,9,4,37,39,29,9,12,23,15
"N00001867",275,35,5,3,2,13,3,32,73,57,21,18,35,18
"N00001868",289,40,7,5,2,42,7,33,85,48,18,11,28,10
"N00001869",234,28,5,5,0,22,8,20,77,37,22,9,27,7
"N00001870",223,34,1,1,0,14,3,31,69,45,14,17,20,9
"N00001871",278,50,12,5,7,31,4,46,85,28,20,15,23,14
"N00001872",176,25,4,3,1,21,1,24,64,31,7,11,5,8
"N00001873",578,139,12,6,6,48,20,119,188,55,45,24,51,16
"N00001874",282,44,9,8,1,30,6,38,78,48,20,14,25,14
"N00001875",202,40,7,2,5,14,6,34,59,40,16,7,12,7
"N00001876",231,38,4,1,3,16,7,31,72,36,11,12,29,13
"N00001877",192,40,8,4,4,15,13,27,61,31,5,9,14,9
"N00001878",237,32,6,4,2,20,4,28,74,52,12,14,20,7
"N00001879",231,48,9,9,0,15,5,43,72,36,8,12,25,6
"N00001880",243,14,6,6,0,20,3,11,39,40,10,32,52,30
"N00001881",687,46,42,23,19,57,5,41,111,112,29,61,130,99
"N00001882",190,21,1,1,0,13,5,16,31,49,9,16,31,19
"N00001883",213,7,19,9,10,16,1,6,25,26,11,20,41,48
"N00001884",162,7,1,1,0,9,1,6,41,37,10,12,26,19
"N00001885",143,8,12,8,4,6,3,5,14,22,6,13,33,29
"N00001886",167,1,18,5,13,14,1,0,8,29,9,23,35,30
"N00001887",205,11,6,3,3,8,3,8,34,38,7,12,61,28
"N00001888",214,12,5,4,1,18,2,10,47,25,19,26,40,22
"N00001889",168,5,13,7,6,14,2,3,17,23,15,12,39,30
"N00001890",408,61,10,7,3,29,13,48,98,83,28,23,48,28
"N00001891",284,44,7,1,6,26,6,38,77,48,21,10,34,17
"N00001892",179,20,5,3,2,10,3,17,37,40,11,13,30,13
"N00001893",183,6,12,5,7,10,0,6,31,27,7,15,36,39
"N00001894",222,13,8,5,3,21,3,10,32,28,8,20,47,45
"N00001895",242,14,11,7,4,19,3,11,35,49,12,18,53,31
"N00001896",390,49,26,17,9,17,6,43,77,47,25,25,75,49
"N00001897",206,10,8,5,3,22,2,8,40,34,7,18,44,23
"N00001898",208,17,8,5,3,13,2,15,32,34,10,25,33,36
"N00001899",152,3,7,3,4,8,1,2,24,17,8,18,42,25
"N00001900",253,41,4,4,0,20,8,33,61,31,54,15,18,9
"N00001901",275,33,6,5,1,30,7,26,63,40,41,14,34,14
"N00001902",323,52,8,5,3,45,10,42,70,54,46,10,29,9
"N00001903",285,55,1,0,1,58,10,45,89,32,20,8,16,6
"N00001904",188,15,3,1,2,21,3,12,47,34,19,12,25,12
"N00001905",195,17,4,3,1,13,3,14,39,39,12,18,35,18
"N00001906",239,28,7,3,4,18,5,23,46,45,36,14,29,16
"N00001907",248,21,9,6,3,22,6,15,53,34,32,23,34,20
"N00001908",240,15,9,7,2,13,2,13,46,37,24,21,32,43
"N00001909",252,14,3,3,0,27,2,12,64,47,26,11,41,19
"N00001910",303,39,7,5,2,29,9,30,65,84,22,19,24,14
"N00001911",203,19,14,8,6,16,6,13,33,25,8,16,50,22
"N00001912",310,60,18,11,7,21,5,55,75,39,18,18,42,19
"N00001913",220,37,5,2,3,20,3,34,63,31,15,18,20,11
"N00001914",242,35,8,2,6,16,2,33,82,32,10,15,32,12
"N00001915",479,102,11,7,4,39,19,83,137,69,20,24,51,26
"N00001916",188,32,10,6,4,17,5,27,54,23,10,7,16,19
"N00001917",206,32,10,4,6,19,5,27,56,36,7,17,19,10
"N00001918",168,28,6,4,2,12,3,25,56,27,8,12,9,10
"N00001919",221,5,17,11,6,16,0,5,30,21,12,18,60,42
"N00001920",244,18,4,3,1,18,3,15,54,47,23,17,36,27
"N00001921",196,1,13,7,6,12,0,1,19,27,4,14,53,53
"N00001922",228,12,15,10,5,14,4,8,38,27,10,15,54,43
"N00001923",182,4,27,15,12,7,2,2,6,24,12,12,50,40
"N00001924",248,11,30,17,13,19,1,10,29,34,10,14,56,45
"N00001925",195,5,16,11,5,12,1,4,21,25,2,20,44,50
"N00001926",234,4,24,18,6,21,1,3,22,27,7,20,53,56
"N00001927",169,9,8,5,3,9,2,7,29,29,10,18,33,24
"N00001928",153,5,9,5,4,14,1,4,21,14,9,17,38,26
"N00001929",337,53,9,5,4,16,13,40,92,45,45,18,37,22
"N00001930",181,6,6,1,5,17,2,4,30,27,9,18,42,26
"N00001931",186,10,10,8,2,14,3,7,34,27,8,15,43,25
"N00001932",209,16,2,2,0,22,5,11,45,50,12,18,27,17
"N00001933",225,25,3,1,2,13,8,17,42,53,21,16,24,28
"N00001934",192,16,10,5,5,7,4,12,41,44,12,11,31,20
"N00001935",255,63,3,1,2,29,5,58,87,27,9,7,21,9
"N00001936",213,26,5,1,4,19,5,21,66,28,18,17,22,12
"N00001937",199,39,9,3,6,23,5,34,54,26,10,5,19,14
"N00001938",222,15,17,14,3,26,3,12,25,18,9,28,49,35
"N00001939",211,24,11,9,2,15,4,20,44,34,8,15,37,23
"N00001940",271,45,5,1,4,30,5,40,77,33,14,11,34,22
"N00001941",191,27,2,1,1,22,5,22,51,25,13,7,30,14
"N00001942",328,37,13,6,7,22,8,29,70,47,55,16,46,22
"N00001943",313,25,15,12,3,26,3,22,51,40,61,28,37,30
"N00001944",265,23,14,9,5,23,4,19,55,29,29,17,43,32
"N00001945",335,29,15,10,5,27,7,22,51,36,70,21,47,39
"N00001946",266,13,8,7,1,15,6,7,41,33,57,18,42,39
"N00001947",320,20,15,13,2,29,2,18,60,33,51,26,49,37
"N00001948",143,5,25,19,6,10,1,4,11,11,7,17,24,33
"N00001949",500,58,28,11,17,47,7,51,158,62,61,23,46,17
"N00001950",184,6,23,15,8,17,0,6,19,15,12,14,35,43
"N00001951",194,24,4,4,0,20,2,22,59,30,19,10,12,16
"N00001952",205,14,14,6,8,17,2,12,48,28,11,19,31,23
"N00001953",151,8,28,18,10,9,2,6,17,18,10,11,27,23
"N00001954",198,29,4,2,2,17,6,23,67,25,15,8,18,15
"N00001955",212,25,16,8,8,20,2,23,59,22,30,8,21,11
"N00001956",142,0,21,15,6,16,0,0,5,15,8,13,30,34
"N00001957",224,5,12,10,2,25,0,5,34,36,19,21,45,27
"N00001958",225,3,35,25,10,20,0,3,15,11,12,29,45,55
"N00001959",185,2,29,16,13,4,0,2,17,15,7,13,62,36
"N00001960",227,4,42,33,9,12,3,1,15,18,7,14,64,51
"N00001961",286,8,14,8,6,34,2,6,50,25,27,23,65,40
"N00001962",162,4,9,3,6,12,0,4,36,22,12,12,37,18
"N00001963",115,2,22,12,10,10,0,2,10,4,1,10,30,26
"N00001964",194,3,29,18,11,12,1,2,14,14,7,8,53,54
"N00001965",226,26,13,7,6,14,1,25,48,43,27,12,27,16
"N00001966",307,19,18,11,7,17,5,14,52,45,32,26,51,47
"N00001967",362,32,20,15,5,27,7,25,56,48,66,19,54,40
"N00001968",230,7,27,17,10,15,0,7,17,15,17,20,58,54
"N00001969",408,34,26,16,10,32,7,27,122,55,33,34,46,26
"N00001970",207,11,15,4,11,18,3,8,26,20,20,19,45,33
"N00001971",308,23,22,17,5,21,4,19,55,45,37,26,41,38
"N00001972",229,35,12,7,5,16,5,30,52,30,25,10,28,21
"N00001973",237,7,22,12,10,17,0,7,25,20,17,26,47,56
"N00001974",152,5,18,14,4,10,0,5,18,12,9,9,40,31
"N00001975",257,12,30,24,6,18,2,10,32,25,17,24,42,57
"N00001976",293,12,15,7,8,18,2,10,33,21,25,32,80,57
"N00001977",188,6,20,15,5,20,1,5,16,19,8,16,49,34
"N00001978",219,6,13,7,6,17,1,5,17,20,18,13,58,57
"N00001979",190,2,30,24,6,10,1,1,20,24,6,15,42,41
"N00001980",220,2,32,23,9,14,1,1,12,16,8,11,58,67
"N00001981",174,5,30,22,8,4,0,5,20,15,7,14,34,45
"N00001982",544,13,38,21,17,50,2,11,88,74,40,51,108,82
"N00001983",185,1,14,7,7,13,0,1,17,23,7,20,49,41
"N00001984",239,10,19,13,6,22,1,9,38,14,16,13,59,48
"N00001985",171,2,20,16,4,16,0,2,16,6,9,15,47,40
"N00001986",298,7,30,16,14,23,1,6,25,29,16,31,64,73
"N00001987",290,10,24,12,12,31,2,8,39,38,21,17,57,53
"N00001988",253,1,24,19,5,17,1,0,14,22,15,24,72,64
"N00001989",246,17,17,12,5,26,5,12,49,33,22,19,45,18
"N00001990",181,6,14,8,6,19,2,4,12,12,5,20,50,43
"N00001991",220,1,29,23,6,16,0,1,17,21,11,12,54,59
"N00001992",193,2,19,10,9,7,0,2,18,14,9,20,39,65
"N00001993",188,4,19,14,5,18,1,3,6,20,7,11,56,47
"N00001994",261,13,11,7,4,23,1,12,48,37,38,16,47,28
"N00001995",251,16,15,10,5,17,2,14,32,27,41,27,40,36
"N00001996",255,9,22,14,8,19,3,6,34,23,45,15,50,38
"N00001997",277,28,12,7,5,24,2,26,57,37,52,13,28,26
"N00001998",189,10,10,8,2,22,2,8,46,21,20,17,25,18
"N00001999",1011,88,28,20,8,417,13,75,197,63,66,30,74,48
"N00002000",233,32,13,6,7,13,3,29,68,29,34,12,22,10
"N00002001",271,28,11,10,1,24,0,28,50,23,65,16,32,22
"N00002002",224,11,14,6,8,16,4,7,47,20,45,15,33,23
"N00002003",228,28,9,5,4,16,5,23,47,18,38,15,28,29
"N00002004",282,18,12,7,5,23,4,14,53,31,58,15,45,27
"N00002005",128,10,3,0,3,8,2,8,28,22,17,7,11,22
"N00002006",188,14,8,4,4,8,4,10,41,14,19,18,29,37
"N00002007",167,19,6,5,1,7,4,15,47,19,28,12,17,12
"N00002008",438,27,34,27,7,27,9,18,67,42,56,28,82,75
"N00002009",207,12,21,16,5,11,2,10,27,23,19,18,31,45
"N00002010",300,26,20,12,8,21,6,20,50,37,55,19,37,35
"N00002011",398,28,17,11,6,41,8,20,68,35,87,28,52,42
"N00002012",347,17,29,22,7,22,2,15,48,35,75,22,38,61
"N00002013",229,4,33,19,14,15,1,3,19,12,33,17,46,50
"N00002014",676,67,45,31,14,67,9,58,167,100,68,38,72,52
"N00002015",216,14,8,4,4,19,1,13,58,31,24,16,29,17
"N00002016",184,5,22,15,7,20,1,4,19,22,4,15,43,34
"N00002017",230,29,14,10,4,20,4,25,53,34,18,13,33,16
"N00002018",984,113,41,32,9,104,22,91,226,133,118,66,116,67
"N00002019",188,18,10,6,4,20,1,17,50,13,25,15,25,12
"N00002020",205,14,15,7,8,17,3,11,49,37,22,16,23,12
"N00002021",308,32,16,10,6,23,6,26,48,28,56,23,42,40
"N00002022",276,19,17,10,7,24,6,13,45,25,40,28,32,46
"N00002023",324,27,11,5,6,23,7,20,59,38,70,27,31,38
"N00002024",342,16,22,13,9,36,4,12,62,41,48,33,47,37
"N00002025",172,6,20,15,5,12,1,5,16,17,25,13,32,31
"N00002026",297,7,43,28,15,16,0,7,27,28,30,31,47,68
"N00002027",186,8,22,20,2,7,0,8,21,14,22,19,34,39
"N00002028",873,80,25,17,8,80,17,63,222,140,77,53,127,69
"N00002029",424,50,18,8,10,43,7,43,92,67,36,19,59,40
"N00002030",239,7,27,17,10,17,1,6,19,20,11,22,59,57
"N00002031",263,16,6,5,1,36,3,13,65,48,15,9,43,25
"N00002032",366,51,6,5,1,24,9,42,94,64,31,18,50,28
"N00002033",198,10,15,9,6,12,3,7,36,36,9,10,36,34
"N00002034",246,26,6,4,2,26,5,21,47,50,20,14,41,16
"N00002035",262,20,11,8,3,31,2,18,57,50,14,16,42,21
"N00002036",256,20,18,11,7,16,1,19,43,32,30,22,44,31
"N00002037",413,42,23,18,5,31,2,40,80,54,85,20,46,32
"N00002038",295,23,12,11,1,21,1,22,54,46,37,24,43,35
"N00002039",230,7,39,29,10,14,1,6,21,17,11,15,52,54
"N00002040",265,14,14,11,3,21,2,12,48,28,56,20,30,34
"N00002041",241,22,12,7,5,22,4,18,44,32,48,16,26,19
"N00002042",199,28,11,8,3,12,4,24,77,27,11,6,20,7
"N00002043",271,26,23,14,9,14,1,25,57,29,18,28,40,36
"N00002044",415,44,26,10,16,21,11,33,96,60,44,20,62,42
"N00002045",247,23,18,16,2,19,3,20,49,36,25,17,40,20
"N00002046",200,20,3,2,1,13,3,17,55,33,13,9,25,29
"N00002047",162,8,17,13,4,15,1,7,36,13,14,16,27,16
"N00002048",134,9,12,11,1,10,1,8,23,13,15,7,27,18
"N00002049",165,15,5,3,2,20,4,11,39,20,20,14,22,10
"N00002050",154,4,18,12,6,5,1,3,20,22,7,15,39,24
"N00002051",364,33,22,16,6,40,4,29,75,36,40,31,53,34
"N00002052",188,20,13,9,4,17,2,18,38,19,15,11,31,24
"N00002053",178,6,15,13,2,21,0,6,25,14,14,20,40,23
"N00002054",335,33,21,13,8,28,6,27,49,36,71,26,40,31
"N00002055",348,24,30,23,7,29,3,21,59,30,50,23,45,58
"N00002056",343,34,23,16,7,22,6,28,66,53,66,21,37,21
"N00002057",299,25,11,11,0,29,7,18,52,31,62,23,30,36
"N00002058",422,21,28,17,11,44,5,16,65,39,97,17,56,55
"N00002059",192,6,24,16,8,14,1,5,24,22,7,18,43,34
"N00002060",691,49,84,54,30,52,12,37,108,61,85,64,100,88
"N00002061",486,48,26,16,10,36,5,43,105,66,62,35,63,45
"N00002062",153,12,11,8,3,10,0,12,29,14,12,16,34,15
"N00002063",277,29,4,3,1,80,4,25,76,24,24,8,20,12
"N00002064",557,64,14,7,7,188,4,60,116,61,25,20,43,26
"N00002065",211,33,14,6,8,30,4,29,61,10,27,8,17,11
"N00002066",239,34,11,6,5,28,4,30,68,36,16,7,25,14
"N00002067",840,59,16,10,6,441,9,50,124,59,41,21,54,25
"N00002068",176,21,7,4,3,30,0,21,48,21,14,12,17,6
"N00002069",312,28,19,13,6,19,4,24,69,45,16,24,50,42
"N00002070",802,62,25,16,9,81,11,51,198,156,65,53,110,52
"N00002071",248,32,5,4,1,14,3,29,78,32,18,16,32,21
"N00002072",218,10,14,7,7,22,4,6,42,29,11,22,40,28
"N00002073",202,3,21,14,7,23,1,2,19,24,7,24,50,31
"N00002074",623,37,33,17,16,71,7,30,119,85,34,40,131,73
"N00002075",274,13,12,8,4,29,2,11,56,46,21,16,50,31
"N00002076",171,4,16,11,5,13,0,4,23,28,17,13,39,18
"N00002077",187,10,6,4,2,12,0,10,34,25,10,21,43,26
"N00002078",198,3,23,17,6,13,0,3,22,18,8,15,56,40
"N00002079",497,40,62,50,12,56,4,36,88,51,39,32,72,57
"N00002080",237,5,29,19,10,21,0,5,18,23,15,23,52,51
"N00002081",216,6,42,29,13,15,1,5,17,11,12,17,47,49
"N00002082",1152,41,32,19,13,711,5,36,88,60,43,29,89,59
"N00002083",224,23,4,1,3,19,5,18,72,40,16,13,31,6
"N00002084",337,28,16,12,4,34,5,23,77,50,22,24,45,41
"N00002085",431,61,14,10,4,60,20,41,128,54,30,19,49,16
"N00002086",376,51,9,5,4,37,7,44,113,60,34,20,34,18
"N00002087",171,7,18,12,6,10,1,6,31,21,10,12,30,32
"N00002088",240,13,20,14,6,20,2,11,49,35,18,17,39,29
"N00002089",283,28,9,8,1,29,5,23,74,63,23,10,35,12
"N00002090",363,12,54,39,15,48,2,10,55,22,46,18,53,55
"N00002091",694,27,89,78,11,70,8,19,85,59,132,51,83,98
"N00002092",367,9,49,38,11,31,1,8,48,40,53,17,52,68
"N00002093",445,15,45,39,6,38,4,11,78,38,60,28,67,76
"N00002094",504,24,33,20,13,32,5,19,83,46,45,44,88,109
"N00002095",342,17,19,15,4,33,4,13,50,39,44,31,45,64
"N00002096",319,23,17,17,0,25,9,14,52,27,67,19,44,45
"N00002097",285,13,20,17,3,26,2,11,40,27,63,19,42,35
"N00002098",291,8,35,30,5,30,2,6,36,20,58,23,39,42
"N00002099",327,15,22,16,6,35,0,15,57,27,54,26,39,52
"N00002100",323,21,29,22,7,27,7,14,42,40,68,14,39,43
"N00002101",394,17,26,21,5,51,5,12,64,37,66,27,52,54
"N00002102",300,6,35,28,7,25,0,6,39,30,66,16,35,48
"N00002103",593,31,49,37,12,71,4,27,94,58,50,47,94,99
"N00002104",205,8,22,16,6,19,3,5,22,19,14,8,36,57
"N00002105",291,15,33,23,10,21,8,7,30,24,23,27,61,57
"N00002106",260,9,21,17,4,25,3,6,44,18,22,33,46,42
"N00002107",407,30,22,15,7,49,4,26,72,35,35,23,87,54
"N00002108",305,7,43,30,13,42,1,6,38,23,19,18,48,67
"N00002109",385,19,37,31,6,47,2,17,60,31,64,23,49,55
"N00002110",379,13,49,37,12,49,5,8,44,38,51,30,43,62
"N00002111",378,20,36,22,14,50,4,16,75,24,71,20,38,44
"N00002112",357,18,46,37,9,40,3,15,52,31,49,29,41,51
"N00002113",385,16,27,21,6,42,4,12,70,37,74,30,47,42
"N00002114",288,11,26,23,3,25,3,8,35,25,19,25,50,72
"N00002115",192,6,22,15,7,12,1,5,19,14,16,19,36,48
"N00002116",198,4,15,9,6,12,1,3,19,13,10,25,63,37
"N00002117",241,14,10,6,4,21,3,11,57,33,27,19,28,32
"N00002118",303,13,16,12,4,40,3,10,35,29,26,22,74,48
"N00002119",209,9,27,21,6,21,3,6,17,22,8,11,39,55
"N00002120",208,9,11,8,3,10,0,9,26,28,32,15,41,36
"N00002121",309,15,16,12,4,23,4,11,52,36,50,28,50,39
"N00002122",363,20,12,9,3,36,7,13,56,30,70,28,58,53
"N00002123",334,22,22,19,3,37,6,16,64,24,59,22,39,45
"N00002124",258,14,17,13,4,12,3,11,36,20,43,27,46,43
"N00002125",920,58,55,41,14,76,19,39,166,86,137,48,149,145
"N00002126",315,21,12,8,4,21,6,15,53,37,42,23,67,39
"N00002127",572,27,52,30,22,40,4,23,93,51,45,40,111,113
"N00002128",554,28,26,20,6,31,5,23,86,61,51,61,112,98
"N00002129",746,31,80,59,21,62,6,25,93,57,74,52,145,152
"N00002130",302,21,21,14,7,15,6,15,47,26,25,23,58,66
"N00002131",295,22,10,7,3,25,4,18,55,30,54,26,32,41
"N00002132",283,10,20,14,6,42,2,8,32,20,47,22,42,48
"N00002133",362,28,15,12,3,36,3,25,63,33,66,23,53,45
"N00002134",252,14,12,12,0,27,1,13,41,18,42,23,37,38
"N00002135",344,18,15,11,4,39,4,14,46,33,59,36,43,55
"N00002136",220,8,21,11,10,16,2,6,23,19,21,19,50,43
"N00002137",224,7,19,14,5,13,3,4,29,25,13,17,54,47
"N00002138",233,8,18,13,5,18,4,4,30,32,23,15,40,49
"N00002139",513,25,40,24,16,46,6,19,92,50,42,44,102,72
"N00002140",198,17,9,6,3,18,3,14,48,25,22,12,23,24
"N00002141",168,5,14,11,3,11,3,2,9,16,8,17,55,33
"N00002142",169,0,22,16,6,7,0,0,17,14,9,13,44,43
"N00002143",322,14,24,18,6,35,0,14,42,28,43,23,45,68
"N00002144",412,23,42,30,12,40,5,18,55,39,56,27,66,64
"N00002145",345,18,36,22,14,48,5,13,56,29,61,20,36,41
"N00002146",290,12,22,12,10,25,2,10,58,22,46,20,37,48
"N00002147",300,12,44,37,7,33,2,10,28,25,28,16,48,66
"N00002148",300,19,16,8,8,36,6,13,52,25,65,24,33,30
"N00002149",295,15,15,9,6,35,2,13,63,28,56,15,37,31
"N00002150",242,16,13,9,4,15,3,13,46,33,47,21,20,31
"N00002151",227,9,15,10,5,23,3,6,42,15,29,16,38,40
"N00002152",283,8,26,19,7,70,3,5,32,18,29,12,34,54
"N00002153",336,17,14,12,2,44,5,12,57,32,71,12,46,43
"N00002154",287,9,18,8,10,41,1,8,41,36,47,21,37,37
"N00002155",374,22,15,10,5,57,7,15,69,31,58,24,46,52
"N00002156",294,10,35,24,11,28,3,7,35,30,26,19,51,60
"N00002157",213,2,61,48,13,13,1,1,18,13,11,15,30,50
"N00002158",331,21,25,17,8,35,5,16,42,39,52,22,38,57
"N00002159",376,27,15,9,6,50,9,18,68,29,69,26,36,56
"N00002160",272,20,14,7,7,28,9,11,52,26,38,21,31,42
"N00002161",338,24,26,22,4,25,6,18,65,26,64,20,39,49
"N00002162",334,13,21,18,3,46,2,11,63,29,55,13,33,61
"N00002163",396,24,21,11,10,28,5,19,77,57,47,33,44,65
"N00002164",231,7,26,21,5,22,5,2,30,14,25,20,46,41
"N00002165",266,24,14,5,9,33,9,15,51,22,22,20,50,30
"N00002166",264,17,10,5,5,25,3,14,47,20,34,12,51,48
"N00002167",242,11,25,14,11,14,3,8,46,23,18,16,49,40
"N00002168",247,7,19,15,4,28,2,5,47,19,24,14,45,44
"N00002169",356,27,19,12,7,28,7,20,56,30,32,26,68,70
"N00002170",238,7,23,11,12,27,3,4,18,22,24,21,38,58
"N00002171",380,34,17,10,7,41,9,25,83,44,48,25,41,47
"N00002172",424,33,16,11,5,38,4,29,73,71,57,29,57,50
"N00002173",345,47,17,14,3,43,6,41,75,38,58,14,29,24
"N00002174",359,26,25,21,4,39,6,20,64,35,56,24,43,47
"N00002175",507,61,19,12,7,44,14,47,105,62,51,37,71,57
"N00002176",423,30,14,9,5,45,11,19,82,64,30,38,61,59
"N00002177",425,43,14,9,5,47,13,30,92,44,63,26,54,42
"N00002178",350,25,21,13,8,38,4,21,56,42,46,22,51,49
"N00002179",248,12,14,7,7,21,5,7,39,35,24,17,55,31
"N00002180",164,7,12,6,6,8,1,6,20,21,7,9,47,33
"N00002181",475,49,4,4,0,42,10,39,115,81,46,34,59,45
"N00002182",263,26,8,5,3,15,11,15,51,36,44,24,36,23
"N00002183",236,9,31,22,9,9,2,7,25,16,18,27,60,41
"N00002184",163,7,19,15,4,6,3,4,15,16,11,14,41,34
"N00002185",329,11,37,24,13,14,5,6,40,33,13,27,92,62
"N00002186",165,6,12,7,5,4,1,5,21,10,6,18,50,38
"N00002187",207,14,17,10,7,8,2,12,31,19,5,12,59,42
"N00002188",132,2,9,6,3,4,0,2,7,7,4,16,39,44
"N00002189",163,8,7,3,4,16,2,6,15,15,4,19,32,47
"N00002190",364,11,45,29,16,23,4,7,56,25,22,30,87,65
"N00002191",154,3,12,6,6,13,2,1,11,9,6,17,45,38
"N00002192",352,22,10,7,3,29,5,17,72,54,31,27,54,53
"N00002193",164,2,20,16,4,15,1,1,15,11,8,22,40,31
"N00002194",162,5,22,14,8,11,3,2,21,10,5,20,33,35
"N00002195",212,9,13,5,8,14,4,5,29,26,30,15,36,40
"N00002196",427,39,21,12,9,49,8,31,87,65,46,28,52,40
"N00002197",459,25,34,24,10,43,3,22,67,51,48,47,79,65
"N00002198",210,7,29,18,11,13,2,5,17,13,7,12,58,54
"N00002199",247,6,25,17,8,21,3,3,22,24,21,19,59,50
"N00002200",297,13,27,19,8,27,7,6,31,33,14,14,63,75
"N00002201",174,3,21,14,7,15,0,3,22,11,7,8,41,46
"N00002202",322,11,19,10,9,30,5,6,61,33,15,23,73,57
"N00002203",843,98,10,7,3,84,24,74,231,122,84,56,102,56
"N00002204",326,35,7,5,2,28,7,28,82,30,55,20,36,33
"N00002205",533,66,10,5,5,55,14,52,144,65,57,37,61,38
"N00002206",244,29,8,4,4,16,4,25,54,33,23,22,36,23
"N00002207",228,17,13,10,3,18,4,13,41,29,16,24,38,32
"N00002208",232,15,17,14,3,29,4,11,33,20,32,17,37,32
"N00002209",270,15,16,8,8,34,6,9,40,34,31,23,39,38
"N00002210",300,24,18,14,4,34,1,23,63,41,46,16,28,30
"N00002211",195,6,19,8,11,7,0,6,22,21,14,24,39,43
"N00002212",177,10,9,3,6,10,5,5,25,26,11,14,45,27
"N00002213",552,24,30,15,15,58,8,16,97,76,64,43,92,68
"N00002214",262,18,5,4,1,37,4,14,49,33,24,25,43,28
"N00002215",211,8,13,7,6,10,2,6,29,29,10,25,48,39
"N00002216",211,11,8,6,2,11,0,11,25,24,8,28,56,40
"N00002217",174,9,10,7,3,11,3,6,33,19,11,19,28,34
"N00002218",177,6,9,5,4,9,1,5,28,24,13,17,40,31
"N00002219",181,2,12,6,6,10,1,1,19,22,15,17,47,37
"N00002220",334,20,11,5,6,24,5,15,45,62,17,33,72,50
"N00002221",320,5,33,21,12,20,0,5,21,30,19,28,77,87
"N00002222",210,6,22,13,9,8,1,5,13,21,6,14,58,62
"N00002223",98,4,2,0,2,3,2,2,10,9,9,10,26,25
"N00002224",148,5,12,8,4,12,1,4,14,23,6,13,32,31
"N00002225",229,4,30,13,17,15,1,3,23,20,13,23,50,51
"N00002226",157,2,19,13,6,11,1,1,10,15,3,19,36,42
"N00002227",170,6,16,12,4,11,2,4,13,18,8,19,46,33
"N00002228",167,6,14,6,8,11,3,3,9,22,13,12,38,42
"N00002229",716,26,58,43,15,76,6,20,78,91,49,57,154,127
"N00002230",205,2,32,23,9,16,2,0,20,17,4,11,49,54
"N00002231",233,4,56,40,16,22,0,4,10,15,8,10,52,56
"N00002232",561,11,55,32,23,34,3,8,54,58,26,48,139,136
"N00002233",255,4,23,12,11,24,1,3,25,22,6,15,74,62
"N00002234",193,4,31,19,12,11,1,3,19,14,7,15,46,46
"N00002235",238,0,49,35,14,25,0,0,18,18,10,13,48,57
"N00002236",458,9,67,50,17,31,4,5,33,37,22,33,106,120
"N00002237",241,3,18,8,10,33,1,2,25,20,7,24,58,53
"N00002238",192,2,21,12,9,25,0,2,14,18,7,15,49,41
"N00002239",193,2,28,18,10,7,1,1,13,14,7,24,40,58
"N00002240",230,7,21,11,10,26,2,5,25,37,13,19,35,47
"N00002241",188,8,24,16,8,9,6,2,23,16,5,17,45,41
"N00002242",208,4,22,13,9,25,0,4,20,25,15,15,40,42
"N00002243",161,3,18,10,8,12,1,2,20,7,15,10,42,34
"N00002244",214,11,22,15,7,20,2,9,38,26,20,8,28,41
"N00002245",136,2,33,30,3,1,1,1,15,10,4,6,28,37
"N00002246",339,21,12,7,5,40,5,16,74,47,28,15,43,59
"N00002247",340,19,13,7,6,54,6,13,62,42,34,23,48,45
"N00002248",551,40,29,20,9,58,6,34,111,71,54,39,76,73
"N00002249",442,43,12,8,4,72,5,38,112,50,32,24,55,42
"N00002250",255,13,9,6,3,24,4,9,40,40,24,19,45,41
"N00002251",303,16,11,7,4,31,5,11,48,29,31,28,52,57
"N00002252",623,34,25,17,8,79,16,18,110,66,97,37,101,74
"N00002253",290,29,17,5,12,30,7,22,52,24,43,23,33,39
"N00002254",430,31,25,19,6,48,7,24,73,55,50,23,67,58
"N00002255",368,31,16,7,9,35,8,23,73,56,34,30,52,41
"N00002256",380,46,12,9,3,36,7,39,75,49,59,23,42,38
"N00002257",237,11,10,6,4,20,0,11,50,34,9,23,40,40
"N00002258",262,34,5,3,2,29,5,29,50,31,39,20,30,24
"N00002259",252,17,17,12,5,16,6,11,42,41,21,20,38,40
"N00002260",563,70,13,8,5,41,13,57,135,73,67,31,81,52
"N00002261",483,45,13,6,7,42,9,36,113,74,54,26,66,50
"N00002262",329,31,14,4,10,43,6,25,86,41,24,25,25,40
"N00002263",346,29,5,3,2,30,10,19,90,43,60,26,37,26
"N00002264",516,17,45,30,15,41,6,11,70,57,38,44,110,94
"N00002265",417,16,37,23,14,38,4,12,52,50,24,34,101,65
"N00002266",213,4,29,19,10,17,1,3,18,15,9,12,53,56
"N00002267",340,13,50,34,16,27,4,9,36,33,14,18,75,74
"N00002268",547,27,40,27,13,62,9,18,79,59,42,44,128,66
"N00002269",227,4,40,33,7,18,0,4,15,21,7,14,46,62
"N00002270",246,6,46,34,12,25,3,3,17,20,7,15,66,44
"N00002271",223,4,40,28,12,26,2,2,11,19,5,12,57,49
"N00002272",190,3,33,26,7,20,1,2,13,17,7,8,44,45
"N00002273",429,28,28,16,12,35,4,24,81,60,30,46,68,53
"N00002274",170,2,28,21,7,18,1,1,9,15,5,10,53,30
"N00002275",181,7,24,15,9,19,1,6,17,10,7,18,57,22
"N00002276",236,15,11,8,3,19,6,9,44,23,17,25,41,41
"N00002277",359,10,39,32,7,27,0,10,45,34,23,28,83,70
"N00002278",249,7,29,20,9,29,2,5,21,21,14,15,57,56
"N00002279",161,3,14,5,9,8,1,2,16,16,3,20,39,42
"N00002280",216,13,23,15,8,19,5,8,21,23,14,22,43,38
"N00002281",298,6,48,33,15,36,1,5,18,21,14,14,64,77
"N00002282",208,3,33,25,8,20,0,3,15,19,14,15,47,42
"N00002283",222,3,29,19,10,18,2,1,13,11,12,18,58,60
"N00002284",222,5,42,29,13,17,3,2,13,16,12,20,40,57
"N00002285",308,27,10,5,5,51,6,21,49,39,27,24,46,35
"N00002286",299,16,18,7,11,26,2,14,48,38,25,25,53,50
"N00002287",238,8,24,9,15,24,2,6,31,18,10,28,47,48
"N00002288",213,2,35,26,9,20,0,2,9,14,8,18,59,48
"N00002289",183,5,13,8,5,16,3,2,15,12,11,27,42,42
"N00002290",328,37,27,25,2,28,7,30,57,54,27,26,41,31
"N00002291",341,26,26,16,10,24,5,21,70,42,23,28,47,55
"N00002292",200,33,9,8,1,20,6,27,58,23,16,2,23,16
"N00002293",178,4,9,5,4,10,0,4,16,16,7,21,43,52
"N00002294",222,14,3,2,1,13,4,10,47,46,18,19,38,24
"N00002295",254,15,12,9,3,19,2,13,56,40,11,36,39,26
"N00002296",276,12,20,16,4,18,3,9,45,43,9,22,73,34
"N00002297",244,24,4,3,1,27,6,18,61,43,15,23,28,19
"N00002298",199,21,9,8,1,13,7,14,41,26,16,14,29,30
"N00002299",258,32,9,5,4,17,5,27,64,44,15,16,37,24
"N00002300",608,86,9,8,1,43,16,70,189,81,55,30,77,38
"N00002301",470,29,13,6,7,35,8,21,136,68,31,36,77,45
"N00002302",471,79,11,9,2,55,13,66,127,76,53,17,36,17
"N00002303",323,23,9,8,1,31,11,12,71,39,15,31,55,49
"N00002304",161,3,26,16,10,10,0,3,10,14,11,18,36,33
"N00002305",612,65,14,7,7,46,10,55,141,93,38,57,95,63
"N00002306",1048,59,59,42,17,81,17,42,204,119,53,103,214,156
"N00002307",295,22,9,4,5,33,4,18,54,45,28,18,44,42
"N00002308",255,23,5,3,2,31,6,17,55,29,30,21,40,21
"N00002309",159,6,14,10,4,6,2,4,16,17,6,19,35,40
"N00002310",150,2,5,5,0,12,0,2,23,21,8,12,37,30
"N00002311",202,10,14,11,3,9,2,8,29,34,12,28,43,23
"N00002312",219,10,26,16,10,10,1,9,22,17,11,17,52,54
"N00002313",226,20,8,7,1,13,6,14,55,50,22,16,23,19
"N00002314",204,18,8,6,2,17,4,14,57,30,11,8,37,18
"N00002315",240,24,5,3,2,26,5,19,54,36,24,19,35,17
"N00002316",191,7,19,14,5,10,0,7,44,25,6,17,38,25
"N00002317",228,19,6,6,0,18,6,13,40,34,17,15,38,41
"N00002318",256,20,9,5,4,14,6,14,56,40,27,25,38,27
"N00002319",457,55,14,9,5,36,16,39,120,68,44,35,54,31
"N00002320",213,10,11,4,7,15,2,8,24,31,17,18,51,36
"N00002321",208,16,8,3,5,15,8,8,44,30,16,20,37,22
"N00002322",243,20,7,3,4,21,7,13,56,47,17,22,33,20
"N00002323",249,13,5,3,2,15,4,9,54,48,23,11,51,29
"N00002324",205,10,7,7,0,21,2,8,36,36,12,16,49,18
"N00002325",352,41,20,16,4,33,15,26,77,69,18,24,41,29
"N00002326",214,17,11,5,6,17,3,14,37,26,19,17,40,30
"N00002327",931,103,28,15,13,86,29,74,228,138,84,75,116,73
"N00002328",285,28,9,6,3,28,6,22,86,50,23,10,31,20
"N00002329",208,16,3,0,3,12,4,12,31,37,23,17,39,30
"N00002330",439,46,8,3,5,32,10,36,115,63,61,28,59,27
"N00002331",425,45,18,13,5,59,10,35,73,55,60,28,50,37
"N00002332",266,21,11,4,7,20,3,18,58,27,20,22,56,31
"N00002333",283,35,10,2,8,23,2,33,66,34,27,21,37,30
"N00002334",268,23,17,12,5,21,7,16,45,30,12,20,53,47
"N00002335",398,53,7,5,2,33,6,47,123,55,34,17,51,25
"N00002336",235,6,10,6,4,26,3,3,35,27,12,22,41,56
"N00002337",282,8,20,13,7,40,3,5,24,19,20,25,64,62
"N00002338",180,4,12,7,5,11,4,0,20,17,8,22,43,43
"N00002339",225,6,7,5,2,17,2,4,32,31,13,28,53,38
"N00002340",230,3,16,10,6,15,1,2,23,20,8,23,70,52
"N00002341",167,3,19,11,8,7,1,2,10,20,11,17,42,38
"N00002342",216,7,23,13,10,14,3,4,26,15,15,24,42,50
"N00002343",242,17,16,10,6,22,6,11,34,22,18,19,55,39
"N00002344",275,9,32,20,12,14,1,8,33,21,11,26,63,66
"N00002345",202,11,12,8,4,8,2,9,30,20,17,16,48,40
"N00002346",185,4,14,6,8,13,2,2,21,16,10,21,38,48
"N00002347",475,25,22,13,9,32,6,19,79,49,39,46,109,74
"N00002348",240,4,17,9,8,8,0,4,47,22,19,22,62,39
"N00002349",175,9,9,5,4,11,1,8,27,32,11,21,34,21
"N00002350",127,3,6,3,3,7,3,0,27,20,2,13,22,27
"N00002351",859,80,37,16,21,78,12,68,199,111,70,65,126,93
"N00002352",198,16,26,23,3,13,4,12,20,18,17,15,38,35
"N00002353",1261,69,86,48,38,118,16,53,212,151,93,96,243,193
"N00002354",279,14,18,12,6,16,2,12,46,44,17,29,52,43
"N00002355",221,3,22,12,10,28,0,3,17,16,12,24,41,58
"N00002356",317,14,21,12,9,34,2,12,53,31,15,31,68,50
"N00002357",249,9,28,14,14,23,3,6,22,31,19,18,40,59
"N00002358",176,3,22,15,7,18,1,2,11,16,4,13,48,41
"N00002359",199,5,28,15,13,16,2,3,13,13,12,21,40,51
"N00002360",169,2,5,3,2,4,0,2,25,35,10,17,30,41
"N00002361",194,2,11,3,8,17,1,1,14,17,8,17,52,56
"N00002362",177,3,11,6,5,13,0,3,14,12,2,20,46,56
"N00002363",163,2,16,9,7,10,1,1,16,16,10,21,36,36
"N00002364",160,2,14,10,4,4,0,2,13,15,8,22,45,37
"N00002365",214,6,21,13,8,18,1,5,16,16,6,19,49,63
"N00002366",196,2,13,12,1,11,0,2,12,11,6,30,50,61
"N00002367",286,20,12,7,5,14,5,15,55,39,26,15,56,49
"N00002368",314,21,11,9,2,34,5,16,55,37,50,26,40,40
"N00002369",552,26,29,18,11,42,8,18,121,68,65,49,70,82
"N00002370",280,24,11,7,4,24,7,17,60,26,70,14,25,26
"N00002371",323,32,9,7,2,35,4,28,74,35,44,25,34,35
"N00002372",421,34,16,14,2,27,4,30,94,58,58,33,48,53
"N00002373",288,21,23,17,6,16,6,15,34,34,40,22,51,47
"N00002374",221,9,15,11,4,11,1,8,29,25,31,21,38,42
"N00002375",281,19,18,5,13,22,2,17,48,39,52,26,34,23
"N00002376",318,31,4,3,1,38,4,27,74,44,43,24,37,23
"N00002377",296,34,12,6,6,21,7,27,65,40,25,25,39,35
"N00002378",533,61,16,11,5,26,11,50,151,78,38,36,73,54
"N00002379",474,49,14,11,3,35,8,41,129,86,38,31,59,33
"N00002380",209,7,10,7,3,13,2,5,33,26,33,18,39,30
"N00002381",279,33,9,3,6,28,12,21,77,52,24,10,28,18
"N00002382",352,25,12,5,7,30,8,17,72,69,33,30,52,29
"N00002383",338,31,1,0,1,39,8,23,104,56,36,19,26,26
"N00002384",287,21,6,3,3,25,6,15,79,56,18,28,32,22
"N00002385",209,17,5,1,4,18,3,14,42,47,13,21,29,17
"N00002386",205,3,27,9,18,14,0,3,20,18,10,18,54,41
"N00002387",371,9,50,35,15,14,1,8,33,54,20,28,81,82
"N00002388",160,4,28,15,13,17,1,3,18,14,12,11,28,28
"N00002389",257,6,27,15,12,26,2,4,25,23,13,17,55,65
"N00002390",232,9,32,20,12,13,0,9,21,23,9,21,61,43
"N00002391",306,37,7,4,3,38,4,33,72,33,39,16,32,32
"N00002392",278,27,7,5,2,38,4,23,49,43,28,15,43,28
"N00002393",450,59,9,6,3,73,15,44,115,62,37,23,45,27
"N00002394",286,16,22,11,11,46,2,14,46,32,24,21,45,34
"N00002395",290,16,11,4,7,34,6,10,60,41,12,24,51,41
"N00002396",217,3,38,20,18,14,1,2,14,17,14,16,49,52
"N00002397",250,8,47,38,9,19,1,7,26,26,12,13,43,56
"N00002398",267,1,48,39,9,19,0,1,20,19,15,21,59,65
"N00002399",199,7,32,23,9,13,2,5,17,21,17,21,34,37
"N00002400",162,10,20,17,3,7,0,10,34,20,11,10,22,28
"N00002401",1073,104,67,29,38,99,19,85,279,127,71,64,164,98
"N00002402",174,29,10,7,3,13,10,19,45,24,15,12,11,15
"N00002403",324,18,19,10,9,15,3,15,87,50,28,32,42,33
"N00002404",664,43,43,29,14,46,10,33,111,100,35,58,135,93
"N00002405",244,15,13,10,3,27,2,13,45,44,22,12,35,31
"N00002406",255,35,21,14,7,23,1,34,73,33,25,10,21,14
"N00002407",218,30,17,12,5,15,8,22,59,32,20,9,22,14
"N00002408",275,47,15,12,3,26,13,34,94,27,31,10,13,12
"N00002409",237,11,13,8,5,24,3,8,38,23,14,17,45,52
"N00002410",231,7,17,11,6,23,1,6,39,25,13,21,42,44
"N00002411",256,56,7,6,1,41,13,43,77,24,25,5,14,7
"N00002412",284,49,8,4,4,49,16,33,82,33,20,4,30,9
"N00002413",311,36,16,8,8,39,9,27,97,36,20,21,28,18
"N00002414",229,41,10,4,6,22,6,35,72,28,24,7,16,9
"N00002415",220,19,18,14,4,18,3,16,58,25,20,17,30,15
"N00002416",344,19,37,28,9,20,8,11,60,36,51,27,43,51
"N00002417",253,15,26,15,11,18,0,15,32,28,54,9,33,38
"N00002418",381,21,22,12,10,44,3,18,67,36,75,17,44,55
"N00002419",461,35,42,25,17,39,8,27,74,56,64,27,61,63
"N00002420",357,20,31,15,16,33,4,16,65,30,71,23,37,47
"N00002421",282,16,18,12,6,31,4,12,48,25,66,8,32,38
"N00002422",361,26,33,20,13,34,5,21,62,37,48,29,53,39
"N00002423",155,0,21,14,7,17,0,0,22,18,5,15,27,30
"N00002424",243,12,32,18,14,29,1,11,49,32,18,8,31,32
"N00002425",225,7,33,22,11,11,1,6,38,32,12,14,45,33
"N00002426",263,11,27,18,9,33,2,9,45,38,8,18,52,31
"N00002427",276,3,51,36,15,31,0,3,28,20,13,21,50,59
"N00002428",240,7,26,12,14,25,1,6,27,22,13,14,49,57
"N00002429",244,3,47,31,16,13,0,3,24,21,8,16,52,60
"N00002430",235,2,52,34,18,29,0,2,21,19,7,9,47,49
"N00002431",709,10,171,125,46,92,5,5,66,48,39,42,127,114
"N00002432",195,5,53,43,10,16,0,5,13,16,5,14,33,40
"N00002433",301,14,39,22,17,50,3,11,38,35,14,24,42,45
"N00002434",166,2,48,36,12,19,2,0,9,9,6,12,27,34
"N00002435",206,2,42,32,10,16,0,2,19,18,11,19,30,49
"N00002436",301,9,42,34,8,43,2,7,37,32,20,22,43,53
"N00002437",208,14,14,8,6,29,2,12,44,19,18,19,30,21
"N00002438",275,8,34,23,11,19,2,6,41,25,15,24,50,59
"N00002439",242,6,35,22,13,23,1,5,20,23,7,18,49,61
"N00002440",237,9,31,23,8,20,2,7,26,13,18,15,55,50
"N00002441",173,2,39,26,13,8,1,1,16,14,9,9,39,37
"N00002442",215,5,43,36,7,22,2,3,20,15,14,15,37,44
"N00002443",255,10,36,25,11,28,1,9,38,28,12,11,48,44
"N00002444",590,39,56,40,16,52,8,31,89,87,26,46,102,93
"N00002445",212,37,10,8,2,14,4,33,66,25,22,9,15,14
"N00002446",189,4,24,13,11,5,0,4,24,26,8,13,43,42
"N00002447",229,5,39,30,9,18,3,2,15,22,7,11,63,49
"N00002448",225,3,30,24,6,20,0,3,25,24,8,15,51,49
"N00002449",216,17,23,19,4,19,1,16,47,19,15,15,34,27
"N00002450",202,11,11,7,4,10,3,8,28,25,16,16,45,40
"N00002451",449,9,92,72,20,47,1,8,38,34,17,24,94,94
"N00002452",232,7,22,13,9,22,1,6,28,25,17,17,52,42
"N00002453",267,13,18,13,5,30,3,10,40,28,24,21,51,42
"N00002454",251,19,26,24,2,22,5,14,43,29,14,20,37,41
"N00002455",294,33,5,5,0,30,7,26,77,51,24,20,40,14
"N00002456",297,35,9,7,2,31,9,26,73,36,31,22,32,28
"N00002457",385,19,12,5,7,29,2,17,87,60,28,33,71,46
"N00002458",223,4,31,22,9,13,1,3,18,30,31,21,27,48
"N00002459",579,35,46,38,8,51,4,31,108,65,83,32,83,76
"N00002460",307,25,23,17,6,32,4,21,63,37,36,24,39,28
"N00002461",399,23,29,20,9,44,6,17,70,50,51,26,64,42
"N00002462",374,13,35,24,11,34,3,10,57,36,60,35,49,55
"N00002463",318,19,39,27,12,41,8,11,49,30,42,24,33,41
"N00002464",296,15,18,13,5,27,2,13,69,21,51,16,40,39
"N00002465",551,6,141,114,27,117,1,5,34,27,12,18,82,114
"N00002466",223,4,44,31,13,34,0,4,12,14,7,16,51,41
"N00002467",226,5,45,37,8,37,0,5,22,20,8,15,33,41
"N00002468",239,9,43,25,18,20,0,9,31,26,18,15,45,32
"N00002469",452,11,78,54,24,47,4,7,48,50,22,30,91,75
"N00002470",280,2,43,30,13,30,0,2,27,20,15,20,69,54
"N00002471",234,7,57,41,16,27,0,7,13,20,7,12,52,39
"N00002472",312,5,77,63,14,39,1,4,17,23,12,19,55,65
"N00002473",256,1,65,45,20,38,0,1,11,22,2,9,58,50
"N00002474",250,2,55,36,19,37,0,2,27,20,13,15,44,37
"N00002475",271,5,56,43,13,33,0,5,24,24,11,12,44,62
"N00002476",271,4,60,40,20,32,1,3,21,27,9,15,47,56
"N00002477",213,2,32,22,10,25,0,2,23,18,13,12,46,42
"N00002478",361,8,56,44,12,67,2,6,33,35,20,23,69,50
"N00002479",371,50,15,9,6,53,10,40,83,39,29,23,50,29
"N00002480",485,38,35,22,13,53,10,28,96,48,56,19,70,70
"N00002481",221,4,50,44,6,45,0,4,15,14,5,16,32,40
"N00002482",214,2,52,42,10,23,2,0,17,20,11,11,44,34
"N00002483",241,4,67,55,12,21,1,3,24,17,6,17,50,35
"N00002484",232,4,61,44,17,32,2,2,20,22,10,11,44,28
"N00002485",203,4,48,36,12,32,1,3,21,12,4,10,46,26
"N00002486",311,3,68,53,15,51,2,1,38,28,19,15,51,38
"N00002487",334,11,21,13,8,52,3,8,53,38,30,24,59,46
"N00002488",895,30,102,74,28,160,7,23,162,77,69,61,143,91
"N00002489",607,71,31,21,10,65,14,57,160,97,36,35,65,47
"N00002490",269,21,19,13,6,26,3,18,49,34,29,22,40,29
"N00002491",244,5,47,36,11,31,3,2,23,17,9,17,47,48
"N00002492",202,3,52,37,15,29,2,1,12,16,8,2,40,40
"N00002493",240,2,45,32,13,14,1,1,18,19,8,13,57,64
"N00002494",192,4,38,29,9,36,1,3,10,17,5,11,32,39
"N00002495",414,13,57,40,17,46,2,11,60,42,23,28,86,59
"N00002496",272,4,46,29,17,29,2,2,23,13,17,27,56,57
"N00002497",394,11,64,45,19,54,1,10,44,39,25,22,56,79
"N00002498",815,30,115,91,24,109,10,20,119,76,47,41,150,128
"N00002499",480,29,31,21,10,54,10,19,100,50,35,35,74,72
"N00002500",382,22,27,14,13,47,4,18,72,47,31,25,59,52
"N00002501",1150,146,51,31,20,165,31,115,341,117,96,44,120,70
"N00002502",371,39,23,17,6,28,10,29,94,41,30,37,47,32
"N00002503",185,41,8,6,2,16,9,32,64,19,16,6,11,4
"N00002504",160,13,16,9,7,8,2,11,19,15,5,12,41,31
"N00002505",197,6,16,12,4,17,2,4,38,25,9,13,43,30
"N00002506",219,7,33,16,17,20,0,7,28,21,11,11,49,39
"N00002507",211,4,26,19,7,34,1,3,21,23,3,20,33,47
"N00002508",151,5,26,11,15,8,1,4,23,10,8,12,27,32
"N00002509",172,2,20,11,9,8,0,2,20,19,8,13,36,46
"N00002510",346,17,58,42,16,29,3,14,52,37,20,28,62,43
"N00002511",129,5,30,22,8,9,0,5,17,12,1,9,23,23
"N00002512",535,34,65,43,22,34,7,27,84,65,36,36,87,94
"N00002513",249,36,6,4,2,36,14,22,57,27,26,12,30,19
"N00002514",300,31,12,9,3,41,8,23,83,44,31,15,30,13
"N00002515",215,16,14,12,2,21,5,11,40,25,32,14,28,25
"N00002516",281,38,9,4,5,34,10,28,64,33,41,19,28,15
"N00002517",232,20,18,15,3,19,4,16,58,35,27,14,27,14
"N00002518",498,55,30,19,11,63,14,41,100,76,36,40,49,49
"N00002519",238,16,26,13,13,23,6,10,38,26,23,14,46,26
"N00002520",582,55,20,10,10,67,13,42,150,81,55,42,68,44
"N00002521",929,69,91,66,25,82,11,58,172,87,60,66,155,147
"N00002522",217,5,34,25,9,23,0,5,26,21,6,14,42,46
"N00002523",245,8,25,18,7,23,2,6,35,23,13,23,51,44
"N00002524",301,11,43,27,16,35,2,9,43,33,15,29,48,44
"N00002525",1278,125,56,31,25,133,25,100,281,174,134,91,178,106
"N00002526",762,125,58,48,10,55,20,105,218,90,58,34,78,46
"N00002527",309,75,7,4,3,42,15,60,94,33,20,7,23,8
"N00002528",236,21,11,4,7,41,5,16,50,29,9,14,38,23
"N00002529",331,31,23,15,8,47,3,28,59,51,27,21,42,30
"N00002530",279,16,15,9,6,40,5,11,75,35,24,8,37,29
"N00002531",394,19,17,11,6,63,9,10,82,62,26,32,56,37
"N00002532",281,15,18,9,9,37,4,11,63,44,25,15,43,21
"N00002533",651,31,85,58,27,57,6,25,104,79,36,50,91,118
"N00002534",329,19,47,36,11,27,3,16,50,39,16,28,54,49
"N00002535",384,26,16,5,11,62,6,20,96,50,30,31,42,31
"N00002536",435,36,20,15,5,29,9,27,62,72,59,32,61,64
"N00002537",1189,43,129,93,36,122,13,30,164,121,132,86,166,226
"N00002538",512,52,39,25,14,60,12,40,111,57,61,25,69,38
"N00002539",201,1,22,16,6,20,0,1,27,20,4,12,48,47
"N00002540",1365,128,116,97,19,145,24,104,293,183,109,82,190,119
"N00002541",996,61,47,31,16,68,14,47,226,162,54,91,164,123
"N00002542",250,22,7,3,4,30,4,18,52,38,19,21,32,29
"N00002543",206,7,23,14,9,15,0,7,38,39,7,16,32,29
"N00002544",488,38,25,15,10,33,6,32,121,67,34,42,74,54
"N00002545",224,10,19,10,9,20,3,7,38,35,12,23,42,25
"N00002546",199,11,12,8,4,16,1,10,38,23,12,21,35,31
"N00002547",728,39,37,25,12,58,11,28,131,130,33,76,127,97
"N00002548",428,9,55,36,19,27,2,7,64,48,21,42,76,86
"N00002549",162,8,4,3,1,8,3,5,40,28,6,9,33,26
"N00002550",210,14,27,17,10,12,3,11,39,33,11,24,35,15
"N00002551",237,8,21,10,11,21,3,5,45,34,15,17,43,33
"N00002552",209,4,28,19,9,13,4,0,21,24,6,20,47,46
"N00002553",171,7,8,3,5,8,2,5,32,27,8,17,36,28
"N00002554",280,18,17,9,8,29,4,14,50,46,15,20,50,35
"N00002555",275,9,17,11,6,27,3,6,40,34,23,24,57,44
"N00002556",236,6,18,7,11,19,2,4,16,25,23,28,49,52
"N00002557",264,8,12,11,1,19,4,4,46,42,16,20,47,54
"N00002558",227,10,16,11,5,16,1,9,33,27,9,27,39,50
"N00002559",191,1,18,12,6,15,0,1,18,14,18,18,50,39
"N00002560",360,64,9,6,3,49,15,49,95,41,43,9,30,20
"N00002561",236,27,11,7,4,15,5,22,73,34,23,11,28,14
"N00002562",252,35,7,4,3,31,4,31,71,30,19,14,27,18
"N00002563",274,21,6,4,2,41,5,16,81,28,24,14,34,25
"N00002564",204,12,12,8,4,13,2,10,31,38,18,18,31,31
"N00002565",221,5,32,24,8,26,0,5,37,30,15,14,34,28
"N00002566",236,21,23,13,10,20,5,16,57,36,21,12,23,23
"N00002567",248,20,18,14,4,44,3,17,48,33,18,15,27,25
"N00002568",229,9,11,8,3,23,1,8,46,35,16,24,37,28
"N00002569",230,21,14,10,4,19,3,18,71,26,22,15,26,16
"N00002570",170,10,14,10,4,14,3,7,39,26,11,14,22,20
"N00002571",291,26,13,8,5,33,6,20,80,41,15,17,43,23
"N00002572",263,29,10,6,4,21,7,22,81,43,19,15,36,9
"N00002573",224,7,38,21,17,16,1,6,33,30,8,14,45,33
"N00002574",234,8,30,17,13,22,1,7,27,26,7,21,50,43
"N00002575",228,4,43,26,17,31,0,4,21,14,12,17,51,35
"N00002576",643,51,110,62,48,69,7,44,116,67,36,45,84,65
"N00002577",433,20,57,32,25,65,2,18,76,49,18,29,64,55
"N00002578",240,5,41,20,21,27,0,5,20,26,10,23,46,42
"N00002579",284,4,82,55,27,40,2,2,26,16,11,14,37,54
"N00002580",228,11,27,18,9,22,2,9,44,30,14,17,28,35
"N00002581",257,22,18,9,9,19,6,16,49,33,19,22,42,33
"N00002582",1033,14,234,178,56,145,2,12,77,66,36,72,169,220
"N00002583",217,5,39,30,9,23,2,3,19,19,9,11,51,41
"N00002584",255,4,45,28,17,37,1,3,19,30,8,15,53,44
"N00002585",186,6,32,25,7,18,0,6,20,19,5,16,35,35
"N00002586",249,2,49,31,18,24,0,2,18,28,10,15,57,46
"N00002587",541,13,107,80,27,61,3,10,40,49,24,38,111,98
"N00002588",203,0,32,27,5,19,0,0,20,23,4,15,43,47
"N00002589",229,9,30,22,8,35,1,8,19,23,10,7,42,54
"N00002590",1029,45,174,120,54,146,10,35,128,83,65,49,185,154
"N00002591",821,56,103,73,30,114,16,40,137,97,54,57,114,89
"N00002592",364,44,11,5,6,53,9,35,90,55,27,20,43,21
"N00002593",220,7,20,15,5,26,2,5,52,30,20,18,32,15
"N00002594",240,5,47,31,16,31,2,3,27,19,7,18,46,40
"N00002595",300,10,57,43,14,44,0,10,36,28,7,17,54,47
"N00002596",325,14,18,7,11,37,2,12,73,51,12,31,47,42
"N00002597",253,14,26,11,15,39,3,11,43,31,23,12,32,33
"N00002598",194,2,34,25,9,23,0,2,16,16,10,12,35,46
"N00002599",318,18,26,15,11,35,5,13,62,39,17,29,53,39
"N00002600",230,14,12,8,4,42,4,10,44,33,21,12,24,28
"N00002601",285,19,20,14,6,34,9,10,65,36,29,21,39,22
"N00002602",277,23,20,13,7,38,3,20,61,32,25,17,39,22
"N00002603",717,25,153,93,60,114,2,23,74,61,36,44,101,109
"N00002604",284,14,40,20,20,79,1,13,45,28,15,13,25,25
"N00002605",221,17,52,36,16,19,0,17,21,22,6,21,30,33
"N00002606",278,4,62,40,22,29,0,4,26,24,15,19,45,54
"N00002607",138,3,29,21,8,10,2,1,14,16,3,10,19,34
"N00002608",209,23,15,6,9,37,2,21,39,26,9,19,23,18
"N00002609",766,29,7,4,3,520,3,26,86,42,25,13,22,22
"N00002610",243,8,20,13,7,63,1,7,30,25,12,19,35,31
"N00002611",109,6,15,7,8,8,0,6,16,11,7,8,27,11
"N00002612",242,18,30,21,9,47,1,17,32,38,20,8,25,24
"N00002613",548,22,86,50,36,48,2,20,72,57,22,35,94,112
"N00002614",295,7,77,54,23,29,0,7,27,32,14,19,48,42
"N00002615",229,6,26,17,9,28,1,5,29,30,6,15,46,43
"N00002616",265,9,45,30,15,21,3,6,27,29,9,13,54,58
"N00002617",306,11,41,23,18,27,1,10,50,34,14,26,52,51
"N00002618",162,4,28,24,4,19,0,4,20,12,8,8,35,28
"N00002619",502,23,85,48,37,36,2,21,75,44,36,45,76,82
"N00002620",374,13,53,32,21,24,1,12,64,37,24,34,76,49
"N00002621",149,2,14,9,5,5,2,0,21,27,6,11,39,24
"N00002622",236,13,34,24,10,19,3,10,34,31,16,13,38,38
"N00002623",199,5,14,11,3,12,3,2,28,19,8,21,48,44
"N00002624",198,9,36,20,16,16,2,7,39,22,10,8,20,38
"N00002625",250,6,43,23,20,25,2,4,26,15,16,22,44,53
"N00002626",596,58,51,34,17,77,9,49,107,58,50,28,96,71
"N00002627",214,4,47,37,10,13,1,3,17,22,5,10,49,47
"N00002628",707,58,114,79,35,83,7,51,79,75,59,36,99,104
"N00002629",169,1,43,33,10,13,0,1,16,16,8,9,25,38
"N00002630",197,7,58,38,20,20,1,6,9,10,14,11,40,28
"N00002631",238,5,38,30,8,26,2,3,33,18,15,21,32,50
"N00002632",275,16,35,26,9,25,3,13,32,23,26,17,60,41
"N00002633",307,19,32,17,15,24,2,17,52,40,38,15,51,36
"N00002634",235,22,7,5,2,25,7,15,68,24,30,15,25,19
"N00002635",243,4,21,14,7,16,2,2,27,17,36,25,50,47
"N00002636",302,9,40,30,10,30,4,5,41,38,40,17,43,44
"N00002637",365,19,17,12,5,28,3,16,89,38,61,16,55,42
"N00002638",335,15,19,12,7,24,2,13,68,36,63,21,47,42
"N00002639",225,7,28,18,10,11,3,4,42,23,27,12,38,37
"N00002640",268,14,10,10,0,20,3,11,86,43,28,8,32,27
"N00002641",263,22,9,5,4,24,6,16,71,42,23,16,35,21
"N00002642",340,31,6,4,2,38,4,27,115,54,26,15,41,14
"N00002643",310,32,5,2,3,27,7,25,103,52,31,14,31,15
"N00002644",235,5,38,28,10,16,2,3,29,22,15,18,47,45
"N00002645",228,8,21,13,8,16,1,7,56,29,16,17,28,37
"N00002646",250,12,11,7,4,16,5,7,33,35,32,15,50,46
"N00002647",557,27,18,9,9,35,6,21,118,79,63,43,86,88
"N00002648",152,13,15,8,7,10,4,9,28,27,14,7,24,14
"N00002649",346,19,44,41,3,26,4,15,60,41,38,29,46,43
"N00002650",233,3,25,9,16,18,1,2,21,21,18,20,57,50
"N00002651",326,28,7,5,2,22,5,23,86,58,28,23,46,28
"N00002652",215,5,22,9,13,16,1,4,20,16,20,17,51,48
"N00002653",311,19,18,9,9,18,2,17,76,46,29,17,49,39
"N00002654",237,12,34,25,9,18,2,10,35,45,12,18,38,25
"N00002655",225,5,35,21,14,20,2,3,25,20,14,18,44,44
"N00002656",472,23,50,34,16,34,4,19,88,53,51,29,83,61
"N00002657",257,6,20,15,5,29,2,4,38,26,18,21,54,45
"N00002658",291,10,41,31,10,27,1,9,36,32,20,18,53,54
"N00002659",234,3,41,29,12,27,0,3,23,19,12,15,39,55
"N00002660",286,16,11,4,7,30,2,14,62,44,33,26,44,20
"N00002661",362,14,39,31,8,25,3,11,31,51,34,25,79,64
"N00002662",271,14,19,9,10,18,5,9,48,36,25,33,41,37
"N00002663",244,8,14,6,8,20,1,7,48,38,26,19,37,34
"N00002664",218,6,23,16,7,15,1,5,20,29,25,9,50,41
"N00002665",215,13,5,3,2,14,1,12,28,31,27,19,36,42
"N00002666",200,17,8,6,2,16,4,13,36,35,28,10,26,24
"N00002667",571,17,70,44,26,52,4,13,75,49,55,51,91,111
"N00002668",217,10,11,10,1,25,1,9,45,19,29,15,34,29
"N00002669",376,24,21,13,8,23,11,13,67,60,72,25,33,51
"N00002670",1256,75,84,63,21,142,15,60,243,131,163,68,193,157
"N00002671",1000,37,64,44,20,117,8,29,212,146,98,70,144,112
"N00002672",223,1,45,33,12,23,1,0,31,13,15,7,55,33
"N00002673",914,27,97,77,20,78,4,23,173,109,91,60,144,135
"N00002674",216,3,25,21,4,20,0,3,29,13,13,14,39,60
"N00002675",289,23,10,8,2,30,3,20,66,42,37,13,42,26
"N00002676",545,31,29,17,12,44,2,29,102,74,66,42,87,70
"N00002677",310,24,10,7,3,35,5,19,63,40,60,16,31,31
"N00002678",273,17,11,9,2,29,4,13,56,31,38,16,43,32
"N00002679",373,21,26,17,9,36,4,17,82,52,29,30,45,52
"N00002680",319,43,9,7,2,44,6,37,80,28,46,13,38,18
"N00002681",308,39,12,7,5,21,10,29,76,29,63,18,26,24
"N00002682",332,36,7,7,0,43,8,28,83,54,36,18,36,19
"N00002683",293,24,2,2,0,32,4,20,59,36,66,18,30,26
"N00002684",328,43,11,7,4,23,6,37,96,36,49,15,31,24
"N00002685",287,23,2,0,2,34,4,19,58,53,64,16,25,12
"N00002686",255,33,8,5,3,17,8,25,71,25,45,13,27,16
"N00002687",220,19,14,3,11,18,2,17,31,28,40,8,29,33
"N00002688",265,28,6,4,2,22,4,24,49,36,59,12,27,26
"N00002689",222,6,19,10,9,14,2,4,18,24,13,32,39,57
"N00002690",175,19,25,23,2,15,2,17,31,18,19,11,20,17
"N00002691",238,15,14,10,4,25,4,11,64,23,25,16,35,21
"N00002692",211,23,11,6,5,15,6,17,60,16,26,16,24,20
"N00002693",213,8,34,26,8,20,2,6,45,20,18,20,24,24
"N00002694",242,18,6,3,3,22,2,16,76,38,16,15,25,26
"N00002695",312,34,13,6,7,44,7,27,74,37,38,24,28,20
"N00002696",223,19,7,4,3,26,3,16,49,31,26,23,26,16
"N00002697",263,25,21,11,10,25,5,20,59,29,26,20,33,25
"N00002698",392,44,20,15,5,28,6,38,130,45,39,28,40,18
"N00002699",261,6,19,15,4,17,3,3,37,34,26,18,44,60
"N00002700",395,17,26,12,14,39,1,16,68,63,49,26,65,42
"N00002701",383,31,19,9,10,42,8,23,71,41,73,26,44,36
"N00002702",267,12,19,15,4,29,4,8,43,39,29,22,38,36
"N00002703",447,42,9,5,4,49,7,35,100,47,79,26,52,43
"N00002704",389,43,14,8,6,53,13,30,98,48,59,14,31,29
"N00002705",333,22,15,9,6,48,4,18,64,43,48,22,38,33
"N00002706",317,18,15,9,6,21,5,13,69,42,59,21,38,34
"N00002707",402,28,12,6,6,33,5,23,116,53,68,18,42,32
"N00002708",184,3,26,20,6,15,2,1,25,11,16,16,26,46
"N00002709",344,34,9,5,4,27,4,30,88,38,50,25,42,31
"N00002710",314,11,26,21,5,19,1,10,59,40,26,19,57,57
"N00002711",532,55,46,27,19,38,8,47,116,56,61,35,75,50
"N00002712",265,14,17,5,12,25,2,12,34,25,66,22,23,39
"N00002713",298,20,14,11,3,19,1,19,60,43,44,17,40,41
"N00002714",354,56,13,9,4,38,10,46,71,40,64,16,28,28
"N00002715",308,29,4,2,2,24,8,21,71,28,63,21,34,34
"N00002716",254,31,11,9,2,24,6,25,48,39,34,16,29,22
"N00002717",398,24,18,15,3,43,5,19,72,42,84,30,49,36
"N00002718",330,27,4,3,1,31,8,19,85,57,36,19,43,28
"N00002719",250,26,9,7,2,16,7,19,62,35,48,8,19,27
"N00002720",242,13,24,19,5,18,1,12,37,34,33,15,41,27
"N00002721",258,19,20,15,5,26,3,16,49,20,40,22,34,28
"N00002722",302,33,12,7,5,35,5,28,69,39,53,14,27,20
"N00002723",289,14,33,21,12,36,2,12,54,24,33,15,42,38
"N00002724",185,12,16,12,4,19,2,10,26,26,14,14,31,27
"N00002725",296,14,8,3,5,25,3,11,61,43,61,13,39,32
"N00002726",984,49,73,47,26,63,30,19,224,239,81,47,124,84
"N00002727",300,10,13,9,4,39,4,6,46,52,45,24,42,29
"N00002728",716,51,40,21,19,58,14,37,147,119,65,51,100,85
"N00002729",204,4,20,11,9,14,3,1,15,17,16,22,52,44
"N00002730",197,5,19,6,13,14,4,1,24,27,16,13,32,47
"N00002731",199,10,23,10,13,15,2,8,20,27,13,16,48,27
"N00002732",219,9,20,12,8,15,1,8,26,29,19,25,39,37
"N00002733",295,24,15,6,9,16,11,13,66,51,31,19,39,34
"N00002734",298,33,7,6,1,33,7,26,85,46,34,14,34,12
"N00002735",277,40,11,8,3,24,7,33,67,39,53,10,21,12
"N00002736",268,24,7,5,2,27,3,21,49,30,61,16,28,26
"N00002737",251,33,5,3,2,20,10,23,48,40,47,14,25,19
"N00002738",348,31,9,6,3,42,1,30,79,46,52,17,38,34
"N00002739",307,34,13,8,5,36,8,26,65,43,56,15,25,20
"N00002740",266,18,12,7,5,19,2,16,63,31,44,12,38,29
"N00002741",321,38,14,12,2,29,5,33,83,42,40,21,31,23
"N00002742",287,9,37,21,16,28,5,4,39,34,32,20,51,37
"N00002743",251,12,18,15,3,18,1,11,54,30,42,17,38,22
"N00002744",199,0,31,28,3,16,0,0,17,17,15,21,51,31
"N00002745",237,4,34,23,11,26,0,4,20,18,12,24,51,48
"N00002746",225,3,20,12,8,16,0,3,43,39,20,21,34,29
"N00002747",173,14,8,8,0,9,2,12,34,20,24,16,29,19
"N00002748",244,15,20,8,12,19,2,13,38,25,55,14,39,19
"N00002749",249,14,32,21,11,23,3,11,52,23,24,18,39,24
"N00002750",196,14,23,16,7,9,4,10,29,21,12,11,43,34
"N00002751",234,5,42,23,19,18,2,3,37,27,11,13,39,42
"N00002752",215,22,9,7,2,13,4,18,50,30,25,10,31,25
"N00002753",388,49,17,9,8,48,7,42,111,42,38,17,44,22
"N00002754",309,36,11,8,3,39,5,31,86,41,31,13,33,19
"N00002755",376,46,41,39,2,39,16,30,99,43,40,15,34,19
"N00002756",235,34,6,4,2,15,12,22,70,48,10,11,32,9
"N00002757",346,37,14,5,9,28,6,31,89,44,26,23,51,34
"N00002758",186,5,14,10,4,12,1,4,36,29,14,21,29,26
"N00002759",231,17,10,5,5,21,2,15,58,35,15,17,33,25
"N00002760",231,26,9,5,4,31,1,25,58,34,18,19,23,13
"N00002761",729,104,16,6,10,74,22,82,210,117,68,43,55,42
"N00002762",264,42,10,4,6,24,6,36,88,37,24,12,15,12
"N00002763",283,26,11,10,1,32,5,21,64,40,51,7,26,26
"N00002764",325,31,11,6,5,30,6,25,76,39,58,19,25,36
"N00002765",272,22,18,14,4,25,6,16,50,39,50,22,28,18
"N00002766",354,23,12,10,2,23,2,21,84,41,76,27,36,32
"N00002767",269,20,16,10,6,24,4,16,57,29,46,15,29,33
"N00002768",266,9,24,21,3,22,1,8,43,35,36,23,40,34
"N00002769",352,32,15,10,5,36,5,27,77,42,70,16,34,30
"N00002770",355,21,13,9,4,45,4,17,74,45,75,19,39,24
"N00002771",194,3,20,15,5,16,0,3,29,16,15,22,37,36
"N00002772",210,13,12,7,5,19,1,12,42,33,40,15,22,14
"N00002773",132,3,15,9,6,9,0,3,20,14,13,9,25,24
"N00002774",454,61,13,9,4,48,16,45,119,58,72,24,35,24
"N00002775",334,34,14,12,2,32,2,32,82,42,50,16,42,22
"N00002776",207,8,11,8,3,20,2,6,58,27,22,18,22,21
"N00002777",170,8,26,15,11,24,2,6,13,8,15,16,29,31
"N00002778",187,12,26,12,14,6,2,10,29,15,18,21,34,26
"N00002779",346,28,18,11,7,25,10,18,75,39,71,26,39,25
"N00002780",260,25,15,11,4,16,5,20,63,26,37,22,26,30
"N00002781",296,37,11,8,3,21,7,30,82,39,48,16,24,18
"N00002782",362,35,14,10,4,39,4,31,87,46,59,24,28,30
"N00002783",316,26,9,8,1,40,6,20,71,39,48,12,43,28
"N00002784",388,20,10,6,4,47,4,16,72,48,80,17,51,43
"N00002785",412,30,41,24,17,38,7,23,60,40,87,18,55,43
"N00002786",379,29,23,13,10,48,1,28,62,42,70,20,45,40
"N00002787",336,15,26,14,12,40,1,14,44,22,71,20,47,51
"N00002788",293,31,16,12,4,34,4,27,46,23,47,15,50,31
"N00002789",374,26,41,35,6,33,4,22,66,39,55,17,50,47
"N00002790",361,24,13,8,5,30,2,22,74,41,42,30,55,52
"N00002791",305,33,10,5,5,33,8,25,78,31,47,17,30,26
"N00002792",343,16,17,13,4,37,2,14,58,32,81,22,42,38
"N00002793",330,14,44,39,5,35,4,10,51,20,42,25,49,50
"N00002794",373,30,26,24,2,37,11,19,54,33,66,21,48,58
"N00002795",365,14,31,24,7,42,6,8,50,32,56,32,56,52
"N00002796",374,17,40,35,5,30,1,16,46,35,64,23,55,64
"N00002797",403,34,14,12,2,43,6,28,69,41,85,27,46,44
"N00002798",306,21,15,10,5,36,6,15,58,27,50,20,39,40
"N00002799",236,7,23,13,10,20,2,5,28,24,33,14,46,41
"N00002800",306,15,22,16,6,28,1,14,64,35,46,25,35,36
"N00002801",366,20,18,16,2,49,6,14,72,33,53,27,46,48
"N00002802",332,17,13,9,4,30,5,12,51,36,54,26,56,49
"N00002803",353,19,22,17,5,25,3,16,67,30,47,22,49,72
"N00002804",267,10,29,24,5,17,4,6,35,21,35,13,46,61
"N00002805",269,13,23,17,6,22,4,9,26,26,32,12,62,53
"N00002806",350,25,20,14,6,31,6,19,57,46,53,32,51,35
"N00002807",279,26,15,13,2,29,6,20,43,27,58,13,38,30
"N00002808",357,29,32,27,5,24,4,25,65,35,59,24,44,45
"N00002809",330,20,17,15,2,41,1,19,65,41,56,23,37,30
"N00002810",252,14,30,28,2,25,2,12,43,18,27,22,28,45
"N00002811",241,17,20,17,3,17,6,11,48,23,32,6,32,46
"N00002812",282,17,24,19,5,31,3,14,36,19,43,23,41,48
"N00002813",301,9,39,29,10,24,1,8,37,27,47,22,45,51
"N00002814",336,19,46,41,5,24,3,16,39,23,17,28,74,66
"N00002815",228,4,42,35,7,11,0,4,18,14,9,12,51,67
"N00002816",274,11,25,15,10,22,4,7,33,24,18,30,49,62
"N00002817",450,18,45,29,16,41,3,15,63,26,35,31,106,85
"N00002818",349,4,50,37,13,16,0,4,29,18,15,25,89,103
"N00002819",340,4,51,43,8,29,2,2,26,24,18,23,77,88
"N00002820",429,31,28,20,8,25,8,23,70,36,86,38,55,60
"N00002821",329,26,11,5,6,32,4,22,54,40,75,19,37,35
"N00002822",287,14,27,19,8,35,2,12,41,30,26,22,43,49
"N00002823",310,14,28,18,10,23,6,8,35,27,40,24,66,53
"N00002824",257,15,23,16,7,14,1,14,30,26,45,19,46,39
"N00002825",462,32,25,20,5,47,0,32,80,51,85,27,61,54
"N00002826",296,26,14,11,3,14,5,21,51,35,70,17,37,32
"N00002827",259,13,15,8,7,25,6,7,46,31,51,15,35,28
"N00002828",252,11,16,11,5,25,3,8,32,34,25,27,46,36
"N00002829",350,18,18,14,4,35,4,14,49,43,58,31,45,53
"N00002830",316,15,13,9,4,41,1,14,47,27,70,21,46,36
"N00002831",330,20,19,11,8,32,3,17,56,32,61,17,44,49
"N00002832",317,19,15,10,5,32,7,12,60,28,43,23,52,45
"N00002833",294,22,15,11,4,28,6,16,56,26,36,18,44,49
"N00002834",383,37,29,24,5,38,5,32,75,40,92,14,27,31
"N00002835",375,16,22,16,6,43,4,12,55,35,74,19,54,57
"N00002836",328,27,18,10,8,41,7,20,62,38,35,24,30,53
"N00002837",245,11,12,7,5,20,1,10,43,30,20,17,39,53
"N00002838",317,18,23,17,6,37,4,14,51,31,60,14,44,39
"N00002839",255,13,12,10,2,13,2,11,40,19,56,16,44,42
"N00002840",1013,48,86,63,23,103,4,44,162,75,158,57,197,127
"N00002841",363,26,45,40,5,49,6,20,80,28,42,19,45,29
"N00002842",429,21,51,39,12,43,3,18,62,36,37,32,75,72
"N00002843",277,12,36,29,7,31,4,8,38,36,33,8,38,45
"N00002844",310,12,64,53,11,20,1,11,43,24,12,19,67,49
"N00002845",226,9,37,32,5,18,3,6,39,16,14,12,34,47
"N00002846",409,17,52,41,11,37,6,11,57,37,49,33,59,68
"N00002847",439,34,25,21,4,43,1,33,83,58,68,25,54,49
"N00002848",901,37,88,62,26,96,7,30,117,75,88,60,152,188
"N00002849",155,3,34,24,10,11,0,3,19,11,10,10,28,29
"N00002850",210,9,36,28,8,20,1,8,17,15,15,12,40,46
"N00002851",296,8,48,31,17,34,1,7,25,19,23,20,56,63
"N00002852",237,8,30,23,7,19,1,7,20,21,12,27,39,61
"N00002853",678,40,83,53,30,71,15,25,104,49,53,57,89,132
"N00002854",349,34,33,28,5,44,8,26,68,30,39,19,44,38
"N00002855",325,15,13,8,5,15,4,11,60,35,38,34,60,55
"N00002856",240,13,16,12,4,22,1,12,33,29,28,9,23,67
"N00002857",354,29,18,9,9,32,3,26,65,36,46,26,42,60
"N00002858",354,10,29,22,7,26,2,8,43,18,11,26,110,81
"N00002859",413,34,17,14,3,28,11,23,61,45,27,43,81,77
"N00002860",260,15,21,11,10,17,2,13,28,27,21,17,55,59
"N00002861",308,14,17,7,10,41,6,8,45,26,13,21,72,59
"N00002862",208,9,13,10,3,17,1,8,35,21,4,15,49,45
"N00002863",243,12,14,9,5,17,5,7,42,30,14,26,49,39
"N00002864",246,27,10,7,3,21,6,21,50,28,14,16,42,38
"N00002865",426,37,11,9,2,52,7,30,79,49,100,12,43,43
"N00002866",344,26,14,8,6,37,9,17,67,37,62,27,46,28
"N00002867",422,25,19,11,8,48,6,19,87,51,67,23,45,57
"N00002868",347,25,43,35,8,31,5,20,55,20,36,23,42,72
"N00002869",298,13,21,15,6,31,4,9,48,26,35,25,44,55
"N00002870",403,20,40,29,11,51,6,14,80,38,45,26,50,53
"N00002871",573,22,65,50,15,52,6,16,72,45,41,42,118,116
"N00002872",226,7,24,17,7,12,1,6,21,12,6,17,57,70
"N00002873",212,7,17,15,2,18,4,3,32,19,16,22,40,41
"N00002874",225,7,35,29,6,23,3,4,15,14,9,14,56,52
"N00002875",766,46,52,39,13,53,8,38,112,89,111,57,143,103
"N00002876",401,23,19,14,5,32,7,16,60,38,67,40,68,54
"N00002877",230,4,32,25,7,9,2,2,18,21,17,30,44,55
"N00002878",147,4,16,8,8,5,1,3,18,8,11,4,50,31
"N00002879",315,32,8,6,2,16,9,23,68,33,41,21,53,43
"N00002880",322,19,8,6,2,25,5,14,54,42,63,20,50,41
"N00002881",359,33,15,9,6,19,6,27,81,40,29,30,64,48
"N00002882",275,11,14,7,7,22,3,8,36,35,42,16,38,61
"N00002883",336,27,18,15,3,29,7,20,53,41,38,28,51,51
"N00002884",359,23,12,11,1,39,3,20,65,49,53,28,50,40
"N00002885",500,23,53,35,18,26,0,23,67,47,19,44,122,99
"N00002886",594,52,29,15,14,49,11,41,95,32,39,51,150,97
"N00002887",475,33,31,21,10,43,6,27,72,67,39,39,85,66
"N00002888",314,42,17,13,4,34,5,37,86,29,30,13,38,25
"N00002889",252,21,15,13,2,14,2,19,43,20,21,14,43,61
"N00002890",274,17,7,6,1,30,4,13,66,26,47,20,35,26
"N00002891",427,32,22,15,7,46,6,26,112,27,53,33,51,51
"N00002892",345,35,19,18,1,32,5,30,70,30,53,15,35,56
"N00002893",196,7,19,18,1,15,2,5,25,26,21,15,35,33
"N00002894",233,15,21,13,8,14,5,10,31,25,20,17,40,50
"N00002895",349,30,18,12,6,37,2,28,75,26,35,27,58,43
"N00002896",243,30,10,8,2,25,3,27,48,24,36,10,28,32
"N00002897",666,60,39,28,11,48,13,47,137,74,60,49,111,88
"N00002898",234,21,12,9,3,18,3,18,48,31,20,17,44,23
"N00002899",222,13,16,11,5,19,3,10,30,21,24,17,41,41
"N00002900",213,12,11,5,6,13,5,7,31,22,13,27,47,37
"N00002901",190,5,16,8,8,13,1,4,31,20,15,11,39,40
"N00002902",235,13,27,22,5,19,1,12,33,13,15,19,44,52
"N00002903",575,19,49,39,10,37,4,15,66,42,34,46,155,127
"N00002904",292,23,25,19,6,30,6,17,48,34,40,20,38,34
"N00002905",306,24,21,15,6,41,6,18,63,33,27,9,48,40
"N00002906",321,21,39,23,16,42,5,16,63,34,19,16,46,41
"N00002907",456,28,34,24,10,61,5,23,87,29,67,28,55,67
"N00002908",325,17,28,18,10,40,2,15,50,35,27,18,51,59
"N00002909",413,30,30,21,9,54,11,19,60,45,67,23,50,54
"N00002910",532,33,47,36,11,71,7,26,79,43,81,31,70,77
"N00002911",521,43,40,33,7,71,12,31,104,53,85,25,43,57
"N00002912",254,25,8,6,2,28,8,17,50,26,33,18,41,25
"N00002913",233,6,10,7,3,22,2,4,44,39,22,18,44,28
"N00002914",882,44,41,25,16,72,14,30,163,138,119,56,133,116
"N00002915",152,8,5,4,1,11,1,7,20,25,25,10,27,21
"N00002916",329,30,11,10,1,37,4,26,58,66,38,21,48,20
"N00002917",212,13,22,14,8,18,2,11,42,21,38,11,18,29
"N00002918",247,12,17,11,6,16,2,10,41,14,46,9,51,41
"N00002919",270,15,20,17,3,39,3,12,51,33,40,11,27,34
"N00002920",243,15,19,10,9,20,1,14,39,32,35,16,38,29
"N00002921",242,8,15,15,0,17,1,7,49,19,58,17,35,24
"N00002922",335,16,27,18,9,33,4,12,54,39,50,19,43,54
"N00002923",260,7,19,11,8,20,1,6,39,25,40,28,37,45
"N00002924",288,16,46,21,25,32,2,14,35,21,30,20,44,44
"N00002925",221,22,16,10,6,13,4,18,40,24,33,10,27,36
"N00002926",271,9,33,23,10,27,1,8,32,28,35,19,46,42
"N00002927",284,9,19,12,7,35,1,8,32,27,44,14,54,50
"N00002928",268,10,22,17,5,21,2,8,49,29,54,18,40,25
"N00002929",515,27,48,36,12,40,6,21,87,44,101,29,72,67
"N00002930",304,18,13,10,3,32,3,15,47,39,41,17,56,41
"N00002931",425,43,8,5,3,21,14,29,93,52,61,25,73,49
"N00002932",252,18,10,6,4,25,2,16,47,28,60,9,33,22
"N00002933",384,20,22,17,5,37,7,13,82,48,53,16,58,48
"N00002934",305,9,21,18,3,30,4,5,43,31,50,20,57,44
"N00002935",287,12,13,9,4,27,1,11,38,35,71,18,49,24
"N00002936",301,19,18,15,3,17,1,18,53,38,46,18,54,38
"N00002937",301,17,20,13,7,20,2,15,32,40,55,17,49,51
"N00002938",308,14,7,2,5,36,4,10,53,33,63,17,53,32
"N00002939",298,10,17,11,6,27,2,8,61,30,70,19,33,31
"N00002940",266,15,19,15,4,22,1,14,41,20,53,19,39,38
"N00002941",215,9,17,8,9,15,0,9,23,23,27,16,34,51
"N00002942",297,20,18,15,3,21,6,14,43,34,58,19,46,38
"N00002943",226,11,10,6,4,18,3,8,50,23,10,28,46,30
"N00002944",413,20,25,15,10,33,7,13,75,60,29,37,91,43
"N00002945",292,18,19,12,7,32,3,15,48,33,19,21,64,38
"N00002946",209,8,24,15,9,12,1,7,25,18,16,14,50,42
"N00002947",280,9,25,19,6,20,2,7,42,31,12,23,67,51
"N00002948",246,26,6,4,2,27,5,21,55,42,30,11,28,21
"N00002949",264,19,10,7,3,22,4,15,62,45,28,14,36,28
"N00002950",274,21,12,9,3,19,3,18,74,45,28,13,38,24
"N00002951",176,13,14,8,6,10,7,6,39,23,17,16,34,10
"N00002952",254,27,6,1,5,27,3,24,68,39,20,21,35,11
"N00002953",169,9,10,8,2,9,2,7,20,21,14,15,42,29
"N00002954",437,46,21,17,4,31,3,43,95,52,67,25,62,38
"N00002955",322,26,19,15,4,21,4,22,74,34,72,11,40,25
"N00002956",276,11,30,23,7,26,0,11,33,28,53,15,48,32
"N00002957",269,17,31,20,11,26,4,13,39,16,18,18,53,51
"N00002958",321,19,25,23,2,25,6,13,48,41,52,23,45,43
"N00002959",363,27,17,13,4,31,7,20,81,47,53,32,45,30
"N00002960",264,22,18,11,7,13,5,17,30,27,52,25,31,46
"N00002961",233,22,8,7,1,16,2,20,39,18,37,23,39,31
"N00002962",274,12,22,13,9,20,4,8,45,23,23,26,57,46
"N00002963",263,11,17,11,6,21,2,9,51,25,32,29,34,43
"N00002964",264,16,22,19,3,18,3,13,42,18,42,12,51,43
"N00002965",236,13,15,10,5,15,0,13,33,19,42,23,38,38
"N00002966",399,18,28,21,7,36,7,11,56,52,59,33,63,54
"N00002967",212,0,24,13,11,16,0,0,19,25,8,15,55,50
"N00002968",207,6,21,15,6,15,1,5,17,18,15,24,45,46
"N00002969",153,5,18,10,8,6,1,4,14,11,10,16,33,40
"N00002970",199,6,30,15,15,9,1,5,19,22,6,21,43,43
"N00002971",218,15,13,7,6,16,5,10,34,18,15,26,36,45
"N00002972",210,3,26,16,10,22,1,2,13,16,11,16,47,56
"N00002973",279,15,15,12,3,27,0,15,36,25,46,30,55,30
"N00002974",235,15,15,11,4,22,4,11,35,16,38,12,34,48
"N00002975",378,28,37,28,9,33,6,22,53,28,60,25,73,41
"N00002976",233,7,29,22,7,26,4,3,16,14,26,16,43,56
"N00002977",286,15,26,14,12,29,2,13,51,20,41,17,42,45
"N00002978",322,14,27,24,3,38,4,10,51,30,34,28,59,41
"N00002979",306,5,37,33,4,27,0,5,26,19,17,26,75,74
"N00002980",275,30,24,23,1,24,4,26,61,38,25,18,40,15
"N00002981",180,22,15,7,8,10,3,19,31,19,16,15,31,21
"N00002982",369,21,37,26,11,19,6,15,63,54,34,28,72,41
"N00002983",239,11,14,10,4,32,4,7,45,30,23,15,42,27
"N00002984",149,3,23,19,4,14,0,3,10,12,10,12,39,26
"N00002985",105,4,19,13,6,9,1,3,13,6,5,8,22,19
"N00002986",281,10,32,22,10,23,0,10,33,31,22,19,61,50
"N00002987",316,21,25,18,7,33,1,20,40,34,31,35,53,44
"N00002988",325,20,22,12,10,30,7,13,39,27,60,27,54,46
"N00002989",337,19,28,22,6,36,4,15,55,30,57,20,46,46
"N00002990",270,12,19,14,5,25,4,8,49,31,49,16,40,29
"N00002991",245,14,17,12,5,16,1,13,42,18,39,21,45,33
"N00002992",348,16,30,15,15,42,2,14,53,27,54,27,48,51
"N00002993",169,7,33,27,6,8,1,6,15,14,11,9,35,37
"N00002994",461,37,31,21,10,30,3,34,79,50,53,40,80,61
"N00002995",436,44,30,18,12,36,7,37,86,40,40,30,81,49
"N00002996",155,3,26,22,4,11,1,2,26,10,8,3,41,27
"N00002997",209,11,20,17,3,16,0,11,33,11,22,17,38,41
"N00002998",183,3,25,18,7,11,0,3,23,20,21,11,32,37
"N00002999",198,4,26,19,7,16,1,3,23,10,17,25,41,36
"N00003000",313,21,23,18,5,32,2,19,39,25,61,25,42,45
"N00003001",187,4,18,13,5,11,2,2,23,15,34,16,35,31
"N00003002",591,17,64,42,22,60,3,14,89,54,81,42,87,97
"N00003003",981,49,67,46,21,71,8,41,179,143,138,78,147,109
"N00003004",211,8,38,35,3,6,2,6,27,25,27,19,32,29
"N00003005",333,24,20,13,7,29,3,21,50,45,66,27,40,32
"N00003006",305,22,11,6,5,39,6,16,74,32,45,16,44,22
"N00003007",333,25,11,6,5,27,6,19,44,53,62,22,53,36
"N00003008",450,16,20,11,9,37,2,14,78,56,57,38,82,66
"N00003009",354,24,8,7,1,41,3,21,67,44,60,21,60,29
"N00003010",278,13,12,7,5,22,3,10,53,48,22,21,54,33
"N00003011",228,13,11,7,4,20,3,10,22,37,28,18,47,32
"N00003012",289,12,10,7,3,27,6,6,42,50,32,31,50,35
"N00003013",316,21,17,12,5,30,6,15,55,45,59,13,44,32
"N00003014",297,21,13,8,5,28,1,20,56,36,41,20,47,35
"N00003015",290,12,17,9,8,20,4,8,48,36,52,20,53,32
"N00003016",231,23,9,4,5,20,6,17,44,27,45,12,30,21
"N00003017",280,11,6,6,0,26,4,7,69,33,20,24,52,39
"N00003018",179,9,16,14,2,11,0,9,20,12,20,15,43,33
"N00003019",406,6,58,40,18,30,3,3,21,28,21,36,101,105
"N00003020",296,15,29,22,7,26,4,11,43,25,27,19,55,57
"N00003021",289,10,33,21,12,25,2,8,43,26,21,21,70,40
"N00003022",199,10,23,18,5,18,0,10,24,15,27,24,34,24
"N00003023",190,4,27,18,9,21,0,4,12,9,6,17,51,43
"N00003024",304,22,43,37,6,21,2,20,53,29,26,23,46,41
"N00003025",231,10,9,6,3,21,3,7,42,29,37,16,48,19
"N00003026",394,22,16,9,7,45,7,15,57,38,67,24,67,58
"N00003027",326,15,21,15,6,35,5,10,42,41,64,30,42,36
"N00003028",334,22,13,9,4,25,6,16,47,45,75,26,46,35
"N00003029",372,32,13,10,3,25,7,25,74,53,53,29,56,37
"N00003030",281,6,38,28,10,29,2,4,30,24,21,25,59,49
"N00003031",348,18,15,11,4,35,4,14,53,23,66,24,70,44
"N00003032",245,16,17,12,5,27,2,14,37,22,49,11,31,35
"N00003033",323,17,25,17,8,17,3,14,49,23,50,22,68,52
"N00003034",179,2,34,22,12,25,1,1,13,11,10,18,33,33
"N00003035",266,5,42,31,11,31,1,4,22,12,20,16,56,62
"N00003036",256,17,32,20,12,17,6,11,30,18,24,17,46,55
"N00003037",274,10,30,25,5,25,4,6,26,27,33,24,53,46
"N00003038",249,5,19,15,4,21,1,4,44,23,52,22,30,33
"N00003039",242,7,34,27,7,21,0,7,46,24,17,22,38,33
"N00003040",338,35,40,30,10,16,4,31,46,29,27,28,54,63
"N00003041",319,17,20,11,9,23,1,16,46,26,31,34,80,42
"N00003042",195,3,21,15,6,11,0,3,35,17,11,17,42,38
"N00003043",149,2,13,9,4,6,0,2,22,15,7,12,36,36
"N00003044",266,23,12,5,7,14,2,21,54,38,33,18,53,21
"N00003045",590,53,26,15,11,54,7,46,135,98,55,55,70,44
"N00003046",247,27,2,1,1,25,5,22,53,41,25,17,30,27
"N00003047",312,10,30,22,8,29,2,8,31,31,56,21,48,56
"N00003048",302,17,23,16,7,35,3,14,42,35,60,10,34,46
"N00003049",243,12,30,24,6,12,3,9,40,23,40,14,36,36
"N00003050",247,9,15,8,7,20,1,8,32,15,39,16,52,49
"N00003051",271,10,31,23,8,12,3,7,32,18,60,13,36,59
"N00003052",208,6,30,23,7,19,1,5,23,15,20,14,40,41
"N00003053",173,21,10,7,3,11,4,17,37,18,25,16,20,15
"N00003054",235,23,10,9,1,16,4,19,71,34,26,15,22,18
"N00003055",258,21,9,6,3,24,5,16,55,33,25,12,49,30
"N00003056",268,25,13,9,4,26,6,19,50,43,28,13,45,25
"N00003057",202,1,24,20,4,10,0,1,23,37,15,15,43,34
"N00003058",222,12,21,11,10,16,2,10,36,22,18,17,45,35
"N00003059",237,9,10,9,1,19,3,6,51,32,23,16,52,25
"N00003060",198,7,23,14,9,7,2,5,23,19,13,15,57,34
"N00003061",344,29,25,19,6,27,7,22,74,28,59,28,38,36
"N00003062",322,22,18,15,3,24,7,15,53,39,63,29,42,32
"N00003063",376,17,28,24,4,34,1,16,67,33,83,28,42,44
"N00003064",312,15,12,8,4,25,1,14,56,46,45,22,47,44
"N00003065",239,5,30,22,8,17,1,4,26,16,27,11,47,60
"N00003066",281,10,17,11,6,21,1,9,44,23,56,20,50,40
"N00003067",233,22,8,5,3,16,7,15,60,37,22,16,24,28
"N00003068",149,7,9,6,3,8,4,3,20,12,4,19,42,28
"N00003069",174,4,14,8,6,10,3,1,12,20,7,24,50,33
"N00003070",198,3,21,12,9,9,0,3,25,18,13,23,48,38
"N00003071",176,2,21,14,7,9,1,1,26,14,8,14,35,47
"N00003072",163,6,10,7,3,13,0,6,14,21,11,14,30,44
"N00003073",310,21,6,3,3,38,8,13,72,45,51,19,40,18
"N00003074",366,25,7,4,3,28,7,18,58,50,57,38,56,47
"N00003075",223,20,7,5,2,11,6,14,55,26,29,22,32,21
"N00003076",370,32,9,3,6,22,9,23,81,55,34,40,53,44
"N00003077",268,10,9,5,4,26,3,7,49,43,20,25,49,37
"N00003078",401,37,1,1,0,35,7,30,111,60,42,38,44,33
"N00003079",222,7,25,20,5,12,0,7,14,31,7,22,50,54
"N00003080",160,5,15,13,2,6,2,3,15,17,6,24,46,26
"N00003081",85,1,11,8,3,0,1,0,4,13,2,6,26,22
"N00003082",164,4,11,10,1,10,2,2,21,22,8,15,45,28
"N00003083",157,2,13,8,5,8,0,2,18,23,10,18,21,44
"N00003084",243,9,17,9,8,18,2,7,25,26,17,28,57,46
"N00003085",204,3,20,11,9,10,2,1,15,25,1,24,53,53
"N00003086",185,2,17,12,5,16,2,0,16,19,6,21,49,39
"N00003087",260,18,13,8,5,16,6,12,57,46,20,19,42,29
"N00003088",101,2,14,9,5,11,0,2,9,7,3,6,23,26
"N00003089",215,11,10,5,5,18,3,8,35,35,10,23,34,39
"N00003090",268,15,7,5,2,25,4,11,59,32,20,29,46,35
"N00003091",296,28,6,1,5,30,7,21,66,56,22,24,36,28
"N00003092",163,7,9,7,2,13,0,7,20,24,13,14,34,29
"N00003093",346,44,7,4,3,28,4,40,106,50,29,32,29,21
"N00003094",193,30,4,4,0,8,5,25,73,28,25,9,11,5
"N00003095",222,23,12,6,6,10,2,21,73,37,33,12,14,8
"N00003096",206,30,8,7,1,11,5,25,50,22,24,21,22,18
"N00003097",434,55,11,6,5,39,10,45,115,75,38,33,41,27
"N00003098",523,16,52,37,15,47,3,13,48,62,47,52,104,95
"N00003099",222,10,15,10,5,10,3,7,37,29,36,16,34,35
"N00003100",251,7,11,5,6,18,1,6,31,25,46,32,34,47
"N00003101",214,8,18,14,4,19,4,4,23,21,14,16,51,44
"N00003102",257,16,7,5,2,27,2,14,45,26,56,21,29,30
"N00003103",208,21,3,2,1,10,6,15,42,32,24,20,35,21
"N00003104",167,6,9,7,2,16,1,5,21,19,13,14,39,30
"N00003105",267,6,24,21,3,15,0,6,30,29,29,30,44,60
"N00003106",142,3,14,11,3,8,0,3,13,10,8,10,41,35
"N00003107",171,3,25,17,8,7,1,2,19,13,5,16,32,51
"N00003108",183,6,17,12,5,16,1,5,27,29,12,14,32,30
"N00003109",224,15,9,2,7,20,5,10,41,38,20,29,26,26
"N00003110",158,4,9,7,2,11,0,4,20,15,10,17,41,31
"N00003111",154,6,16,12,4,14,2,4,19,23,7,15,27,27
"N00003112",185,7,12,8,4,10,1,6,26,28,9,16,41,36
"N00003113",197,17,11,9,2,13,3,14,23,25,6,19,43,40
"N00003114",214,7,16,13,3,17,3,4,17,21,4,36,51,45
"N00003115",162,5,11,7,4,11,2,3,16,17,9,11,52,30
"N00003116",211,18,4,4,0,25,2,16,54,32,13,16,31,18
"N00003117",188,13,16,7,9,8,3,10,32,27,8,26,36,22
"N00003118",133,4,16,15,1,7,2,2,12,14,7,19,24,30
"N00003119",176,8,25,17,8,8,1,7,28,9,12,16,24,46
"N00003120",252,20,9,7,2,14,4,16,59,53,26,20,24,27
"N00003121",222,21,9,5,4,21,3,18,45,35,22,16,36,17
"N00003122",181,8,2,0,2,17,1,7,33,25,16,29,31,20
"N00003123",266,18,15,9,6,21,5,13,38,27,69,13,37,28
"N00003124",221,21,16,9,7,18,6,15,37,20,22,22,35,30
"N00003125",211,22,10,6,4,13,3,19,29,27,19,17,37,37
"N00003126",314,18,7,5,2,26,3,15,47,26,59,40,57,34
"N00003127",314,24,6,3,3,25,2,22,62,38,61,18,43,37
"N00003128",196,4,13,8,5,6,1,3,30,32,15,19,35,42
"N00003129",242,15,9,4,5,24,4,11,46,42,39,18,26,23
"N00003130",230,10,4,4,0,22,5,5,56,29,23,17,43,26
"N00003131",589,60,24,19,5,42,13,47,133,67,97,54,63,49
"N00003132",224,19,6,2,4,19,6,13,43,38,22,18,40,19
"N00003133",283,28,12,9,3,29,4,24,77,45,24,21,27,20
"N00003134",224,10,24,17,7,10,5,5,31,35,17,22,43,32
"N00003135",111,5,8,6,2,15,2,3,19,19,5,9,21,10
"N00003136",277,19,12,4,8,18,3,16,56,47,20,24,46,35
"N00003137",230,8,23,19,4,6,3,5,36,25,35,30,35,32
"N00003138",196,6,18,12,6,16,1,5,25,25,7,19,48,32
"N00003139",318,17,9,1,8,16,6,11,65,60,47,23,55,26
"N00003140",259,10,5,3,2,24,3,7,52,55,40,20,43,10
"N00003141",278,37,8,4,4,17,4,33,73,33,42,17,31,20
"N00003142",670,69,23,12,11,50,16,53,162,110,64,46,85,61
"N00003143",201,8,11,7,4,11,2,6,28,27,15,23,42,36
"N00003144",223,22,3,2,1,20,5,17,58,30,27,20,22,21
"N00003145",950,65,39,21,18,62,11,54,180,147,58,106,172,121
"N00003146",279,18,9,4,5,17,6,12,46,47,17,26,65,34
"N00003147",699,59,13,12,1,51,17,42,177,140,56,65,79,59
"N00003148",239,17,8,3,5,26,2,15,47,31,19,21,47,23
"N00003149",411,32,13,10,3,32,9,23,84,74,31,44,59,42
"N00003150",278,32,6,4,2,22,6,26,58,37,58,23,24,18
"N00003151",186,7,15,11,4,10,1,6,16,23,11,27,40,37
"N00003152",301,15,6,5,1,23,3,12,50,42,62,27,40,36
"N00003153",274,34,8,6,2,19,8,26,61,41,36,18,32,25
"N00003154",275,19,14,10,4,23,5,14,33,41,57,26,38,24
"N00003155",186,5,8,5,3,9,0,5,22,28,7,20,47,40
"N00003156",171,8,12,6,6,7,1,7,21,25,11,19,36,32
"N00003157",171,8,4,4,0,12,0,8,30,21,16,20,31,29
"N00003158",170,4,8,6,2,12,0,4,24,20,13,22,32,35
"N00003159",320,15,13,9,4,23,5,10,44,45,24,49,55,52
"N00003160",161,5,16,8,8,8,1,4,16,19,9,27,41,20
"N00003161",1079,60,47,27,20,139,16,44,223,191,96,67,169,87
"N00003162",645,31,60,35,25,59,6,25,103,98,55,43,120,76
"N00003163",346,28,26,17,9,34,5,23,66,45,56,20,43,28
"N00003164",381,26,15,7,8,25,6,20,85,56,51,32,48,43
"N00003165",239,4,26,18,8,19,1,3,31,23,16,27,40,53
"N00003166",388,25,20,10,10,45,5,20,76,54,59,28,46,35
"N00003167",212,18,7,5,2,25,4,14,40,24,35,7,33,23
"N00003168",299,9,27,18,9,34,4,5,47,36,29,21,50,46
"N00003169",252,7,43,29,14,21,0,7,33,18,25,19,45,41
"N00003170",558,12,68,46,22,50,2,10,61,60,63,50,96,98
"N00003171",217,2,39,29,10,23,1,1,11,8,10,23,45,56
"N00003172",184,6,35,24,11,19,2,4,9,7,8,12,39,49
"N00003173",237,9,31,22,9,23,0,9,29,28,18,19,46,34
"N00003174",178,4,43,31,12,12,0,4,11,17,12,11,28,40
"N00003175",273,2,66,49,17,29,2,0,22,30,9,18,45,52
"N00003176",351,30,34,22,12,52,3,27,63,36,47,16,32,41
"N00003177",485,11,81,52,29,57,3,8,45,56,61,28,53,93
"N00003178",241,9,20,16,4,25,3,6,35,20,33,13,38,48
"N00003179",390,18,49,30,19,38,6,12,54,42,56,22,43,68
"N00003180",181,9,8,7,1,9,5,4,31,35,15,15,30,29
"N00003181",242,8,16,10,6,24,1,7,52,32,25,20,43,22
"N00003182",240,14,13,8,5,32,3,11,48,47,18,15,33,20
"N00003183",310,12,19,11,8,42,3,9,47,41,28,29,53,39
"N00003184",230,2,33,23,10,22,1,1,28,21,13,21,48,42
"N00003185",176,2,25,18,7,20,0,2,22,14,8,17,30,38
"N00003186",209,4,47,37,10,20,0,4,15,18,7,18,46,34
"N00003187",242,9,25,19,6,21,2,7,37,27,20,19,44,40
"N00003188",443,27,31,15,16,36,6,21,69,49,90,33,44,64
"N00003189",284,4,27,15,12,43,2,2,34,33,53,6,36,48
"N00003190",319,16,29,23,6,46,3,13,51,24,76,10,30,37
"N00003191",258,8,40,30,10,27,0,8,19,24,38,13,29,60
"N00003192",299,10,29,13,16,18,2,8,28,30,46,10,55,73
"N00003193",293,15,17,12,5,34,4,11,45,34,48,20,42,38
"N00003194",326,13,40,27,13,33,2,11,37,35,49,21,41,57
"N00003195",394,20,35,20,15,34,3,17,56,34,58,26,61,70
"N00003196",302,9,18,12,6,28,0,9,51,50,37,26,40,43
"N00003197",279,13,14,9,5,27,0,13,49,27,36,27,50,36
"N00003198",234,9,11,8,3,29,2,7,42,32,22,22,46,21
"N00003199",339,12,19,14,5,26,1,11,65,39,62,27,46,43
"N00003200",306,16,24,18,6,32,4,12,45,30,57,27,31,44
"N00003201",330,13,22,14,8,37,2,11,46,37,47,25,50,53
"N00003202",309,17,23,17,6,28,8,9,44,29,49,21,36,62
"N00003203",261,11,26,16,10,9,1,10,29,34,34,25,39,54
"N00003204",381,11,64,50,14,39,5,6,48,41,23,21,53,81
"N00003205",366,20,41,27,14,32,1,19,60,46,43,28,46,50
"N00003206",240,11,16,10,6,28,0,11,44,34,33,16,31,27
"N00003207",303,25,15,10,5,32,2,23,58,39,40,22,39,33
"N00003208",295,8,27,20,7,27,2,6,48,36,28,20,38,63
"N00003209",932,59,68,21,47,64,5,54,184,144,72,78,142,121
"N00003210",191,6,22,13,9,19,1,5,22,19,20,9,32,42
"N00003211",203,5,38,28,10,24,1,4,12,17,11,10,44,42
"N00003212",252,9,49,33,16,20,3,6,25,19,15,12,48,55
"N00003213",168,3,32,22,10,9,1,2,20,9,7,5,32,51
"N00003214",165,0,59,46,13,12,0,0,8,3,5,13,24,41
"N00003215",194,2,23,15,8,16,1,1,25,14,5,17,41,51
"N00003216",284,12,26,19,7,21,5,7,29,32,44,27,46,47
"N00003217",225,16,19,14,5,9,6,10,42,24,41,15,32,27
"N00003218",320,22,24,16,8,31,6,16,55,52,47,22,42,25
"N00003219",719,40,113,103,10,27,5,35,66,44,106,58,92,173
"N00003220",275,12,21,15,6,26,3,9,35,30,22,21,48,60
"N00003221",223,19,8,6,2,21,2,17,55,44,18,10,23,25
"N00003222",256,15,19,12,7,23,2,13,54,33,27,21,38,26
"N00003223",225,4,36,27,9,14,0,4,22,22,16,17,39,55
"N00003224",216,7,13,10,3,16,2,5,33,37,15,21,38,36
"N00003225",231,21,7,3,4,17,6,15,63,39,25,11,27,21
"N00003226",198,23,11,4,7,18,5,18,51,36,18,8,14,19
"N00003227",160,14,14,10,4,8,1,13,34,22,10,10,21,27
"N00003228",235,10,26,13,13,13,2,8,29,36,21,18,37,45
"N00003229",169,6,37,35,2,8,3,3,18,15,9,8,30,38
"N00003230",169,4,35,24,11,8,0,4,16,15,8,22,29,32
"N00003231",111,4,23,20,3,13,0,4,7,6,15,7,19,17
"N00003232",355,23,28,21,7,34,6,17,53,51,48,25,47,46
"N00003233",288,9,52,41,11,25,3,6,31,24,32,19,47,49
"N00003234",410,13,36,28,8,42,3,10,50,38,74,28,55,74
"N00003235",374,19,29,19,10,42,1,18,61,43,70,22,38,50
"N00003236",312,19,43,27,16,38,5,14,37,33,34,15,42,51
"N00003237",680,36,66,42,24,74,9,27,120,69,112,28,83,92
"N00003238",418,29,13,9,4,52,3,26,67,34,90,14,50,69
"N00003239",306,28,15,13,2,30,7,21,50,29,76,19,28,31
"N00003240",672,60,77,68,9,33,6,54,104,46,89,80,74,109
"N00003241",280,32,9,4,5,21,8,24,65,36,60,13,31,13
"N00003242",254,31,6,5,1,15,6,25,57,36,43,14,25,27
"N00003243",336,37,8,7,1,35,8,29,86,52,47,14,41,16
"N00003244",250,31,9,7,2,23,8,23,53,34,36,15,33,16
"N00003245",334,39,5,4,1,24,7,32,89,44,58,18,37,20
"N00003246",588,57,46,42,4,43,12,45,148,81,45,35,82,51
"N00003247",567,70,11,8,3,46,15,55,157,82,56,44,61,40
"N00003248",252,15,9,8,1,16,6,9,54,40,33,19,38,28
"N00003249",288,26,8,2,6,22,4,22,59,56,19,27,41,30
"N00003250",259,20,9,7,2,17,3,17,70,47,24,16,37,19
"N00003251",208,17,7,4,3,24,3,14,48,34,17,12,31,18
"N00003252",214,8,30,20,10,17,2,6,23,28,10,12,53,33
"N00003253",213,9,10,8,2,11,2,7,40,35,20,19,47,22
"N00003254",166,25,6,1,5,6,6,19,43,30,10,11,23,12
"N00003255",217,15,15,12,3,25,1,14,46,33,17,18,35,13
"N00003256",278,35,8,4,4,33,5,30,91,50,11,15,22,13
"N00003257",262,38,4,1,3,32,11,27,92,42,13,10,22,9
"N00003258",396,81,3,2,1,53,15,66,109,62,37,16,23,12
"N00003259",252,32,4,3,1,28,7,25,62,45,14,12,37,18
"N00003260",271,31,1,1,0,24,8,23,89,44,23,19,17,23
"N00003261",330,60,5,2,3,58,14,46,89,49,15,15,28,11
"N00003262",270,51,3,2,1,20,7,44,72,38,44,8,26,8
"N00003263",297,38,6,3,3,28,4,34,77,42,49,10,24,23
"N00003264",302,40,3,3,0,41,8,32,82,50,52,10,18,6
"N00003265",285,42,5,2,3,23,5,37,58,41,63,13,23,17
"N00003266",274,45,3,2,1,32,15,30,70,31,51,14,18,10
"N00003267",295,31,1,1,0,26,4,27,90,38,46,13,30,20
"N00003268",259,27,8,3,5,25,6,21,55,31,54,18,29,12
"N00003269",267,34,7,7,0,20,3,31,63,31,46,15,33,18
"N00003270",256,43,7,5,2,26,13,30,56,39,49,13,12,11
"N00003271",407,12,41,27,14,44,2,10,38,49,21,38,90,74
"N00003272",418,21,49,44,5,37,5,16,50,68,24,38,74,57
"N00003273",566,71,13,6,7,47,13,58,146,96,47,38,74,34
"N00003274",213,8,24,17,7,15,3,5,38,27,7,16,51,27
"N00003275",157,2,17,7,10,9,2,0,19,15,6,9,51,29
"N00003276",431,62,11,6,5,35,7,55,108,84,21,34,54,22
"N00003277",354,35,3,1,2,34,4,31,83,64,24,23,53,35
"N00003278",336,16,22,12,10,35,6,10,45,43,24,39,61,51
"N00003279",172,4,11,7,4,12,2,2,20,15,10,19,51,30
"N00003280",652,96,16,15,1,70,13,83,191,94,65,35,51,34
"N00003281",260,8,12,6,6,22,2,6,39,34,50,25,32,38
"N00003282",1575,128,56,30,26,110,24,104,342,303,115,125,244,152
"N00003283",198,11,11,3,8,10,2,9,33,26,14,22,40,31
"N00003284",208,11,12,6,6,11,2,9,34,27,11,17,42,43
"N00003285",188,4,9,7,2,8,1,3,24,29,8,13,51,42
"N00003286",197,13,10,6,4,14,1,12,32,33,10,20,32,33
"N00003287",182,8,8,4,4,6,0,8,50,24,14,10,40,22
"N00003288",217,10,7,4,3,20,2,8,46,37,18,21,28,30
"N00003289",237,28,3,2,1,19,2,26,62,42,21,10,29,23
"N00003290",364,44,11,6,5,29,10,34,81,43,46,22,55,33
"N00003291",516,114,6,3,3,38,22,92,155,73,54,20,39,17
"N00003292",231,15,2,2,0,14,2,13,72,50,6,19,30,23
"N00003293",258,9,26,18,8,39,0,9,43,35,34,16,28,28
"N00003294",238,6,59,44,15,30,0,6,15,22,9,13,51,33
"N00003295",577,6,116,95,21,104,2,4,49,58,26,20,109,89
"N00003296",243,5,58,41,17,31,1,4,20,25,11,8,39,46
"N00003297",270,5,55,46,9,44,0,5,24,25,10,14,50,43
"N00003298",386,3,89,74,15,78,0,3,29,34,8,17,72,56
"N00003299",429,7,107,80,27,78,2,5,22,48,12,19,75,61
"N00003300",177,1,43,33,10,17,0,1,11,10,7,12,37,39
"N00003301",251,4,36,31,5,27,1,3,31,26,10,16,55,46
"N00003302",340,6,61,52,9,44,2,4,34,32,16,25,63,59
"N00003303",268,7,63,51,12,41,3,4,18,28,17,17,38,39
"N00003304",204,2,44,33,11,18,0,2,25,16,7,14,46,32
"N00003305",301,1,71,60,11,47,0,1,24,29,12,13,51,53
"N00003306",430,20,37,26,11,62,10,10,68,62,18,36,85,42
"N00003307",401,47,18,13,5,38,6,41,82,45,29,31,67,44
"N00003308",1918,137,158,129,29,196,29,108,361,319,134,118,279,216
"N00003309",217,6,23,15,8,22,2,4,26,30,12,22,45,31
"N00003310",224,5,17,8,9,17,3,2,20,22,13,26,56,48
"N00003311",831,34,56,38,18,114,7,27,142,155,78,54,122,76
"N00003312",310,11,25,14,11,52,4,7,47,42,26,20,50,37
"N00003313",1027,128,74,45,29,34,15,113,209,150,84,65,157,126
"N00003314",542,97,12,10,2,66,23,74,164,97,25,18,49,14
"N00003315",143,18,3,2,1,9,5,13,49,32,9,6,9,8
"N00003316",260,19,10,5,5,19,5,14,53,28,24,19,50,38
"N00003317",245,24,1,1,0,20,6,18,63,39,35,15,29,19
"N00003318",699,117,8,4,4,75,22,95,202,104,72,27,62,32
"N00003319",263,38,12,5,7,26,7,31,66,52,17,14,32,6
"N00003320",220,22,10,6,4,25,6,16,63,31,14,14,27,14
"N00003321",300,33,6,6,0,27,3,30,75,38,50,15,30,26
"N00003322",299,28,6,3,3,30,6,22,71,38,52,15,35,24
"N00003323",319,37,12,8,4,36,4,33,70,40,56,19,35,14
"N00003324",256,21,12,5,7,15,4,17,51,44,29,12,45,27
"N00003325",323,34,14,4,10,27,6,28,72,50,52,16,31,27
"N00003326",439,20,22,16,6,15,3,17,80,86,55,38,76,47
"N00003327",271,68,7,6,1,18,10,58,81,30,37,11,9,10
"N00003328",164,40,1,0,1,6,6,34,60,26,5,7,14,5
"N00003329",247,71,9,6,3,30,11,60,55,23,29,6,13,11
"N00003330",251,65,2,0,2,22,10,55,82,33,21,7,10,9
"N00003331",328,83,3,3,0,28,13,70,105,37,38,10,17,7
"N00003332",270,43,9,5,4,25,6,37,55,38,47,11,29,13
"N00003333",210,35,5,2,3,21,3,32,58,28,26,11,18,8
"N00003334",233,48,1,1,0,24,12,36,55,34,26,10,21,14
"N00003335",185,21,5,2,3,17,5,16,50,19,10,11,32,20
"N00003336",295,39,6,5,1,24,12,27,73,36,56,15,29,17
"N00003337",232,33,6,2,4,20,4,29,58,45,13,11,28,18
"N00003338",190,15,15,8,7,13,1,14,64,28,12,11,17,15
"N00003339",316,63,4,3,1,34,10,53,83,54,21,17,22,18
"N00003340",162,26,8,7,1,11,5,21,42,22,14,9,15,15
"N00003341",232,24,12,10,2,28,4,20,52,37,18,14,23,24
"N00003342",266,42,12,7,5,30,6,36,79,34,20,5,29,15
"N00003343",213,12,21,10,11,24,4,8,34,32,14,17,41,18
"N00003344",210,28,5,4,1,10,4,24,54,39,18,16,18,22
"N00003345",265,17,7,2,5,52,3,14,67,42,20,23,22,15
"N00003346",367,35,6,3,3,76,8,27,86,66,24,21,38,15
"N00003347",359,46,4,1,3,70,8,38,106,60,18,14,27,14
"N00003348",445,75,14,11,3,76,13,62,113,70,28,20,37,12
"N00003349",702,69,33,20,13,58,20,49,180,105,72,40,78,67
"N00003350",420,45,20,13,7,46,12,33,102,43,59,17,53,35
"N00003351",291,17,16,8,8,34,5,12,60,29,34,24,46,31
"N00003352",298,23,13,5,8,28,5,18,77,49,22,20,40,26
"N00003353",276,28,8,6,2,26,8,20,69,40,27,23,37,18
"N00003354",348,30,15,8,7,47,7,23,71,29,43,34,36,43
"N00003355",345,31,8,4,4,40,9,22,69,46,43,25,40,43
"N00003356",422,29,12,7,5,25,10,19,90,72,40,44,68,42
"N00003357",260,19,10,6,4,26,5,14,48,36,46,20,36,19
"N00003358",336,21,15,10,5,37,5,16,73,37,58,27,42,26
"N00003359",280,22,6,4,2,29,6,16,58,31,52,14,37,31
"N00003360",155,7,9,5,4,8,0,7,24,14,4,17,36,36
"N00003361",191,26,10,6,4,16,7,19,47,33,11,15,18,15
"N00003362",243,47,5,2,3,22,10,37,66,35,22,13,20,13
"N00003363",520,28,20,13,7,48,7,21,99,74,37,39,99,76
"N00003364",286,34,9,7,2,32,5,29,91,46,14,13,36,11
"N00003365",380,71,13,10,3,39,12,59,121,42,38,12,30,14
"N00003366",213,19,3,2,1,21,1,18,65,29,19,6,38,13
"N00003367",237,19,11,5,6,19,6,13,66,40,19,17,28,18
"N00003368",219,15,15,6,9,14,3,12,34,24,12,18,40,47
"N00003369",225,19,11,4,7,10,4,15,40,28,19,21,40,37
"N00003370",202,10,10,2,8,12,4,6,32,18,19,22,33,46
"N00003371",253,13,15,11,4,18,0,13,42,31,9,15,67,43
"N00003372",260,6,33,24,9,18,3,3,27,30,15,12,61,58
"N00003373",209,4,16,11,5,15,0,4,21,33,4,18,47,51
"N00003374",208,10,20,12,8,19,3,7,37,22,8,14,40,38
"N00003375",182,10,10,7,3,14,1,9,26,19,9,21,32,41
"N00003376",215,6,11,9,2,19,2,4,34,30,9,22,41,43
"N00003377",185,4,12,5,7,13,1,3,30,16,13,11,40,46
"N00003378",185,10,4,2,2,9,1,9,30,26,21,19,34,32
"N00003379",214,4,16,9,7,17,0,4,26,21,10,25,57,38
"N00003380",237,1,25,19,6,15,0,1,20,26,4,25,60,61
"N00003381",234,4,29,23,6,30,1,3,22,15,12,22,47,53
"N00003382",181,10,20,15,5,6,3,7,12,23,11,17,42,40
"N00003383",184,18,16,13,3,9,6,12,32,24,8,15,29,33
"N00003384",297,37,4,1,3,19,8,29,90,49,18,23,35,22
"N00003385",321,54,3,2,1,30,5,49,86,51,39,14,28,16
"N00003386",265,18,23,8,15,20,5,13,54,33,19,17,47,34
"N00003387",244,53,5,4,1,21,8,45,76,35,21,13,15,5
"N00003388",251,45,11,6,5,15,7,38,71,42,21,11,20,15
"N00003389",294,70,4,2,2,47,12,58,98,35,19,4,8,9
"N00003390",254,37,6,0,6,24,5,32,58,49,20,10,34,16
"N00003391",284,37,8,3,5,7,6,31,61,36,27,23,40,45
"N00003392",313,41,10,7,3,35,5,36,81,39,55,14,19,19
"N00003393",284,51,4,3,1,22,12,39,60,43,36,13,29,26
"N00003394",294,54,4,1,3,29,9,45,79,35,43,12,30,8
"N00003395",201,45,7,5,2,7,11,34,55,18,20,6,25,18
"N00003396",306,70,2,1,1,27,19,51,82,34,50,14,16,11
"N00003397",199,15,23,19,4,32,6,9,29,29,9,10,23,29
"N00003398",298,21,19,15,4,35,3,18,65,64,14,17,38,25
"N00003399",312,16,14,11,3,43,3,13,80,45,25,16,45,28
"N00003400",326,33,15,8,7,40,6,27,93,54,22,17,39,13
"N00003401",296,29,12,8,4,43,7,22,85,48,18,14,25,22
"N00003402",296,4,55,37,18,29,1,3,29,35,15,11,64,54
"N00003403",197,2,38,27,11,27,1,1,16,20,9,12,37,36
"N00003404",222,2,41,32,9,22,0,2,17,24,8,18,44,46
"N00003405",251,3,41,34,7,19,0,3,37,25,5,20,57,44
"N00003406",263,11,13,7,6,20,1,10,36,37,14,23,61,48
"N00003407",443,42,9,8,1,22,12,30,112,58,37,44,74,45
"N00003408",353,29,20,13,7,24,10,19,69,54,36,20,53,48
"N00003409",253,16,9,7,2,8,4,12,37,33,23,32,48,47
"N00003410",485,49,18,7,11,33,10,39,84,74,38,35,89,65
"N00003411",204,19,10,7,3,17,2,17,39,35,9,20,25,30
"N00003412",226,8,9,6,3,22,0,8,24,30,12,14,53,54
"N00003413",212,7,10,4,6,14,4,3,24,31,18,21,44,43
"N00003414",288,32,12,8,4,24,12,20,60,48,15,13,60,24
"N00003415",237,7,13,8,5,18,1,6,33,34,20,26,44,42
"N00003416",225,6,13,10,3,19,2,4,29,31,14,17,56,40
"N00003417",176,4,12,10,2,24,2,2,26,22,7,10,35,36
"N00003418",184,5,21,13,8,10,2,3,14,25,10,15,41,43
"N00003419",236,16,8,7,1,16,3,13,49,52,19,17,43,16
"N00003420",217,6,13,6,7,18,2,4,33,16,9,18,60,44
"N00003421",204,5,26,17,9,16,0,5,17,17,5,21,59,38
"N00003422",351,47,20,17,3,29,7,40,73,53,31,13,52,33
"N00003423",327,13,21,18,3,14,0,13,60,31,14,26,74,74
"N00003424",222,6,10,4,6,23,2,4,33,28,11,24,45,42
"N00003425",145,7,10,7,3,9,4,3,22,16,7,12,28,34
"N00003426",552,54,29,11,18,45,12,42,122,75,41,27,91,68
"N00003427",239,12,11,6,5,16,1,11,44,29,20,23,43,41
"N00003428",226,15,5,2,3,15,2,13,43,39,12,26,47,24
"N00003429",204,3,15,9,6,10,1,2,17,32,8,20,59,40
"N00003430",195,7,24,22,2,19,4,3,18,28,10,16,38,35
"N00003431",209,2,17,11,6,15,1,1,26,20,8,20,54,47
"N00003432",222,20,5,1,4,11,2,18,66,25,23,17,30,25
"N00003433",178,8,9,4,5,14,1,7,37,26,10,14,38,22
"N00003434",204,16,7,6,1,21,4,12,51,25,8,23,29,24
"N00003435",156,5,7,5,2,10,2,3,20,23,12,13,36,30
"N00003436",253,16,6,4,2,24,1,15,49,53,21,21,41,22
"N00003437",249,27,3,3,0,28,7,20,60,40,20,16,34,21
"N00003438",276,33,3,1,2,19,7,26,55,48,23,22,42,31
"N00003439",205,23,4,1,3,12,1,22,58,43,8,16,31,10
"N00003440",214,23,5,3,2,14,8,15,62,35,14,13,26,22
"N00003441",261,25,7,3,4,15,4,21,47,47,17,16,59,28
"N00003442",160,8,3,1,2,9,2,6,28,31,12,13,28,28
"N00003443",510,39,12,10,2,30,9,30,118,112,55,39,72,33
"N00003444",310,37,8,2,6,34,10,27,77,44,36,22,30,22
"N00003445",348,32,1,1,0,28,7,25,87,76,32,17,47,28
"N00003446",291,35,3,2,1,25,8,27,67,52,29,22,40,18
"N00003447",217,11,8,5,3,8,7,4,27,48,18,23,42,32
"N00003448",399,43,16,12,4,27,8,35,85,59,62,26,40,41
"N00003449",301,42,7,4,3,26,5,37,62,41,67,8,29,19
"N00003450",248,19,6,3,3,23,4,15,63,35,39,18,27,18
"N00003451",472,39,8,5,3,32,9,30,102,92,46,30,81,42
"N00003452",321,32,11,7,4,30,10,22,63,40,58,25,40,22
"N00003453",249,6,14,9,5,10,2,4,81,65,8,25,22,18
"N00003454",229,15,5,3,2,23,3,12,63,37,13,16,38,19
"N00003455",223,28,5,3,2,16,4,24,52,41,20,9,34,18
"N00003456",208,17,4,3,1,10,5,12,66,44,7,19,31,10
"N00003457",196,10,2,1,1,15,2,8,44,31,7,15,43,29
"N00003458",259,20,9,7,2,25,2,18,60,50,10,19,32,34
"N00003459",166,8,4,2,2,8,0,8,41,35,18,11,23,18
"N00003460",296,28,9,6,3,36,1,27,73,53,19,22,39,17
"N00003461",205,25,4,4,0,16,8,17,59,35,19,7,28,12
"N00003462",300,52,2,0,2,34,10,42,91,47,13,12,32,17
"N00003463",343,54,2,0,2,23,11,43,77,54,50,22,39,22
"N00003464",274,45,7,2,5,22,4,41,91,43,15,20,17,14
"N00003465",207,9,14,8,6,18,1,8,24,25,10,18,45,44
"N00003466",212,40,5,3,2,11,4,36,51,40,24,15,17,9
"N00003467",333,85,4,2,2,10,21,64,104,42,41,14,21,12
"N00003468",212,45,4,2,2,8,10,35,66,30,16,9,24,10
"N00003469",269,30,10,7,3,12,8,22,39,30,25,29,54,40
"N00003470",263,22,4,1,3,31,5,17,49,53,40,11,26,27
"N00003471",202,9,15,12,3,14,1,8,28,28,16,20,37,35
"N00003472",232,22,5,2,3,17,3,19,62,39,31,15,22,19
"N00003473",271,25,18,10,8,29,2,23,59,28,20,21,43,28
"N00003474",301,50,6,6,0,19,10,40,109,50,22,10,24,11
"N00003475",794,152,17,12,5,61,32,120,218,114,69,40,78,45
"N00003476",535,75,9,4,5,46,17,58,146,67,55,28,74,35
"N00003477",332,32,8,4,4,13,5,27,93,70,37,21,35,23
"N00003478",596,84,15,9,6,56,16,68,157,104,32,33,77,38
"N00003479",578,142,10,8,2,46,19,123,191,78,41,19,38,13
"N00003480",178,5,19,12,7,10,0,5,20,16,10,23,43,32
"N00003481",121,23,1,0,1,12,6,17,40,21,7,6,8,3
"N00003482",198,9,13,5,8,12,1,8,32,23,25,17,39,28
"N00003483",251,5,29,15,14,23,1,4,24,33,19,21,49,48
"N00003484",219,5,23,10,13,21,1,4,23,15,12,12,52,56
"N00003485",188,5,10,8,2,9,0,5,18,15,15,28,50,38
"N00003486",242,5,20,14,6,24,3,2,29,13,9,23,53,66
"N00003487",236,6,19,9,10,22,1,5,17,21,13,16,60,62
"N00003488",185,5,27,17,10,18,0,5,16,11,4,28,48,28
"N00003489",452,10,52,32,20,39,4,6,39,38,22,28,121,103
"N00003490",179,2,35,29,6,18,0,2,17,20,10,11,31,35
"N00003491",427,10,76,55,21,45,1,9,33,61,19,29,82,72
"N00003492",284,5,40,33,7,27,2,3,30,41,16,24,52,49
"N00003493",490,13,80,63,17,55,3,10,40,67,9,34,112,80
"N00003494",585,32,31,19,12,67,8,24,97,117,49,42,82,68
"N00003495",333,27,15,9,6,37,6,21,82,50,23,26,42,31
"N00003496",422,18,44,28,16,66,1,17,59,73,24,25,60,53
"N00003497",286,3,20,13,7,33,1,2,44,43,7,17,58,61
"N00003498",173,7,10,4,6,14,2,5,31,24,9,16,34,28
"N00003499",163,8,6,5,1,20,1,7,21,23,2,17,42,24
"N00003500",214,25,7,6,1,12,5,20,50,26,11,15,45,23
"N00003501",208,18,11,4,7,23,1,17,34,33,12,13,32,32
"N00003502",149,3,6,4,2,7,0,3,28,11,9,13,46,26
"N00003503",256,17,17,9,8,40,4,13,51,29,16,11,40,35
"N00003504",256,27,9,5,4,23,6,21,56,34,14,26,44,23
"N00003505",146,4,6,4,2,14,1,3,18,16,8,18,32,30
"N00003506",283,9,15,13,2,24,1,8,42,29,11,22,76,55
"N00003507",180,4,12,8,4,14,1,3,22,24,12,17,40,35
"N00003508",210,8,12,10,2,15,2,6,28,23,6,19,50,49
"N00003509",204,11,6,3,3,15,0,11,39,37,17,15,37,27
"N00003510",232,6,17,12,5,15,1,5,22,23,10,26,52,61
"N00003511",172,6,8,7,1,12,2,4,25,31,14,14,33,29
"N00003512",209,12,13,8,5,19,3,9,31,23,5,21,47,38
"N00003513",337,9,26,17,9,23,1,8,45,38,24,25,73,74
"N00003514",469,9,84,61,23,56,2,7,42,50,26,32,91,79
"N00003515",186,5,26,21,5,25,4,1,15,26,8,14,29,38
"N00003516",226,5,35,24,11,34,1,4,19,31,7,14,50,31
"N00003517",419,3,79,58,21,45,1,2,40,41,22,25,81,83
"N00003518",200,7,33,22,11,13,1,6,14,21,11,12,47,42
"N00003519",136,2,20,17,3,12,0,2,10,18,12,7,27,28
"N00003520",201,4,29,20,9,20,1,3,16,24,19,15,36,38
"N00003521",614,38,3,3,0,31,21,17,194,247,11,21,37,32
"N00003522",295,40,18,14,4,28,6,34,80,35,29,15,35,15
"N00003523",271,59,3,3,0,31,11,48,94,32,22,6,14,10
"N00003524",864,127,11,8,3,77,44,83,262,136,55,46,96,54
"N00003525",256,31,2,1,1,19,5,26,61,42,19,24,41,17
"N00003526",219,34,0,0,0,16,11,23,67,39,16,11,23,13
"N00003527",358,21,24,13,11,45,2,19,68,35,49,31,24,61
"N00003528",627,63,29,19,10,68,21,42,110,71,106,38,77,65
"N00003529",333,17,19,14,5,39,4,13,42,41,51,23,40,61
"N00003530",326,18,18,13,5,27,1,17,66,41,57,25,25,49
"N00003531",276,16,12,7,5,38,1,15,48,31,37,20,31,43
"N00003532",314,20,7,7,0,35,3,17,64,29,56,30,35,38
"N00003533",404,24,23,12,11,39,2,22,75,44,51,39,51,58
"N00003534",216,10,19,11,8,20,3,7,35,17,24,15,28,48
"N00003535",347,24,13,12,1,41,4,20,74,31,62,20,37,45
"N00003536",373,22,30,24,6,50,3,19,49,28,65,19,51,59
"N00003537",222,4,29,26,3,19,0,4,18,27,18,20,33,54
"N00003538",319,22,18,7,11,28,3,19,53,33,33,24,41,67
"N00003539",240,23,11,8,3,21,4,19,54,30,18,11,40,32
"N00003540",195,10,17,11,6,19,1,9,30,18,15,14,39,33
"N00003541",188,12,13,10,3,14,3,9,31,15,20,10,34,39
"N00003542",187,3,26,23,3,12,0,3,15,14,11,21,33,52
"N00003543",383,23,12,8,4,39,2,21,99,35,59,22,47,47
"N00003544",270,14,38,32,6,18,4,10,51,27,35,12,31,44
"N00003545",331,21,14,7,7,36,3,18,62,29,62,14,30,63
"N00003546",234,14,17,12,5,14,6,8,38,26,24,20,36,45
"N00003547",464,27,22,17,5,37,7,20,107,46,82,30,54,59
"N00003548",1214,66,97,71,26,111,14,52,199,114,134,88,162,243
"N00003549",381,24,18,12,6,42,4,20,70,37,86,33,31,40
"N00003550",348,55,20,17,3,49,8,47,100,40,36,7,25,16
"N00003551",354,51,17,10,7,35,6,45,79,42,39,16,47,28
"N00003552",318,18,29,20,9,26,6,12,66,27,39,22,45,46
"N00003553",262,29,10,3,7,29,6,23,55,33,29,18,29,30
"N00003554",170,3,20,16,4,21,1,2,16,14,13,14,32,37
"N00003555",268,9,29,21,8,28,0,9,29,29,27,15,47,55
"N00003556",500,4,61,39,22,50,1,3,40,20,30,36,101,158
"N00003557",168,3,20,16,4,7,1,2,23,8,10,13,40,44
"N00003558",347,19,29,19,10,34,10,9,54,34,58,24,39,56
"N00003559",373,17,19,11,8,31,4,13,68,46,57,22,57,56
"N00003560",366,36,14,7,7,43,5,31,78,25,79,25,27,39
"N00003561",343,20,13,8,5,28,5,15,67,35,77,21,37,45
"N00003562",320,28,18,15,3,27,6,22,80,38,33,17,36,43
"N00003563",349,18,16,12,4,43,6,12,49,27,48,29,50,69
"N00003564",286,20,16,12,4,32,6,14,61,35,38,21,34,29
"N00003565",317,29,13,7,6,40,11,18,60,28,54,19,39,35
"N00003566",362,27,16,10,6,45,7,20,82,33,54,23,39,43
"N00003567",360,24,18,15,3,36,2,22,71,35,66,34,36,40
"N00003568",285,21,10,8,2,19,4,17,44,28,46,22,43,52
"N00003569",371,19,3,3,0,52,4,15,51,44,73,25,50,54
"N00003570",387,24,17,12,5,43,4,20,53,38,67,22,59,64
"N00003571",229,9,20,12,8,14,3,6,50,22,22,22,29,41
"N00003572",352,17,19,18,1,28,4,13,67,29,64,23,43,62
"N00003573",312,23,13,9,4,39,6,17,62,37,50,18,43,27
"N00003574",330,21,14,11,3,43,4,17,56,35,64,20,38,39
"N00003575",365,16,11,5,6,43,0,16,51,37,68,34,43,62
"N00003576",361,24,19,15,4,26,5,19,61,32,61,27,48,63
"N00003577",313,14,27,20,7,25,0,14,34,27,50,19,46,71
"N00003578",392,36,26,19,7,35,6,30,83,36,58,30,39,49
"N00003579",334,24,12,10,2,37,1,23,63,25,62,24,40,47
"N00003580",316,22,22,14,8,41,7,15,84,25,35,21,24,42
"N00003581",497,24,30,20,10,49,6,18,74,56,36,37,92,99
"N00003582",424,22,39,24,15,41,5,17,62,40,55,27,67,71
"N00003583",494,36,30,21,9,44,4,32,92,46,61,33,68,84
"N00003584",221,5,23,18,5,28,2,3,17,14,22,13,33,66
"N00003585",244,11,26,15,11,23,1,10,13,23,21,26,44,57
"N00003586",224,2,29,20,9,13,0,2,23,16,18,23,49,51
"N00003587",342,23,14,12,2,27,6,17,74,39,64,28,32,41
"N00003588",418,32,27,21,6,47,10,22,87,46,74,25,36,44
"N00003589",389,27,31,19,12,52,3,24,56,36,53,26,42,66
"N00003590",435,24,23,16,7,44,0,24,71,46,91,20,43,73
"N00003591",390,20,25,20,5,34,1,19,65,49,86,20,42,49
"N00003592",272,15,13,5,8,24,1,14,49,32,45,21,32,41
"N00003593",394,19,41,35,6,39,2,17,53,36,55,25,57,69
"N00003594",638,44,21,13,8,47,10,34,97,65,66,60,120,118
"N00003595",249,18,12,6,6,23,4,14,36,30,32,22,32,44
"N00003596",210,18,14,11,3,21,5,13,34,16,29,12,31,35
"N00003597",333,18,11,11,0,28,3,15,65,34,68,22,39,48
"N00003598",268,31,11,8,3,20,6,25,68,29,27,24,39,19
"N00003599",304,24,20,11,9,22,4,20,56,43,31,18,41,49
"N00003600",281,1,34,27,7,37,0,1,27,31,24,29,46,52
"N00003601",289,22,11,9,2,37,8,14,58,30,17,15,54,45
"N00003602",273,9,26,20,6,33,2,7,42,29,11,26,42,55
"N00003603",252,19,12,9,3,28,6,13,40,31,24,11,35,52
"N00003604",238,9,19,7,12,19,3,6,27,23,9,22,43,67
"N00003605",237,6,45,24,21,19,3,3,16,14,11,17,48,61
"N00003606",283,21,5,5,0,25,2,19,60,40,23,28,34,47
"N00003607",353,51,7,2,5,29,12,39,108,46,23,16,37,36
"N00003608",346,29,21,14,7,32,6,23,56,35,35,21,46,71
"N00003609",232,6,28,20,8,31,2,4,25,17,14,11,54,46
"N00003610",216,5,15,7,8,20,2,3,27,22,18,14,46,49
"N00003611",197,4,24,18,6,13,1,3,25,16,14,9,38,54
"N00003612",331,15,15,9,6,40,3,12,50,50,57,24,34,46
"N00003613",302,21,10,7,3,21,3,18,42,38,56,25,45,44
"N00003614",323,20,19,15,4,36,2,18,58,33,56,16,46,39
"N00003615",240,7,13,7,6,19,3,4,31,34,29,25,35,47
"N00003616",261,13,15,9,6,32,3,10,37,29,38,23,38,36
"N00003617",238,8,23,20,3,20,6,2,25,22,14,23,41,62
"N00003618",341,19,18,12,6,53,2,17,58,30,77,26,29,31
"N00003619",316,17,19,11,8,30,1,16,52,17,55,19,53,54
"N00003620",366,25,23,21,2,41,7,18,66,33,47,24,65,42
"N00003621",302,17,17,6,11,35,3,14,54,25,58,15,37,44
"N00003622",414,25,26,23,3,48,4,21,70,40,66,27,40,72
"N00003623",222,4,20,15,5,22,0,4,20,19,24,23,33,57
"N00003624",490,29,31,19,12,31,2,27,79,50,88,34,70,78
"N00003625",316,9,43,30,13,24,0,9,26,25,50,16,59,64
"N00003626",261,18,9,6,3,21,2,16,51,30,49,14,41,28
"N00003627",233,8,29,18,11,10,2,6,16,17,16,23,62,52
"N00003628",241,14,15,7,8,4,0,14,37,28,29,20,47,47
"N00003629",180,14,17,11,6,24,1,13,55,14,25,11,7,13
"N00003630",435,43,34,23,11,20,6,37,118,36,80,25,44,35
"N00003631",140,9,20,13,7,8,2,7,12,10,14,13,31,23
"N00003632",217,21,16,10,6,13,5,16,58,13,32,14,31,19
"N00003633",178,0,46,35,11,10,0,0,11,8,4,10,43,46
"N00003634",227,6,10,5,5,19,1,5,25,25,32,21,39,50
"N00003635",220,10,10,7,3,20,0,10,31,15,42,21,43,28
"N00003636",246,16,13,5,8,20,3,13,48,23,50,7,37,32
"N00003637",292,28,12,8,4,33,6,22,81,39,29,20,31,19
"N00003638",331,19,21,12,9,45,2,17,67,52,37,17,35,38
"N00003639",228,20,9,2,7,24,7,13,59,28,37,9,24,18
"N00003640",243,10,34,26,8,21,1,9,31,21,21,17,45,43
"N00003641",338,20,14,9,5,23,2,18,59,27,109,17,42,27
"N00003642",274,16,29,18,11,16,3,13,51,24,53,21,27,37
"N00003643",303,10,22,8,14,17,0,10,49,40,45,26,47,47
"N00003644",221,27,18,12,6,14,4,23,52,31,26,17,21,15
"N00003645",375,20,28,19,9,30,2,18,70,33,42,31,59,62
"N00003646",388,30,16,11,5,46,7,23,76,52,41,28,67,32
"N00003647",497,22,45,29,16,45,6,16,79,48,97,39,68,54
"N00003648",306,14,18,12,6,30,2,12,56,31,64,20,43,30
"N00003649",366,21,27,20,7,40,4,17,57,37,69,23,43,49
"N00003650",275,24,17,13,4,26,1,23,72,28,52,11,28,17
"N00003651",233,18,22,14,8,20,0,18,40,23,26,9,35,40
"N00003652",460,16,40,35,5,53,1,15,89,46,104,19,54,39
"N00003653",260,17,17,12,5,27,3,14,50,22,46,17,31,33
"N00003654",175,7,23,16,7,17,0,7,20,14,13,12,29,40
"N00003655",148,4,23,17,6,9,0,4,16,7,25,6,25,33
"N00003656",339,18,24,19,5,33,5,13,64,37,44,26,51,42
"N00003657",279,11,14,8,6,18,5,6,48,24,33,23,55,53
"N00003658",402,17,17,10,7,38,4,13,72,28,99,21,56,54
"N00003659",274,20,27,20,7,18,5,15,36,18,61,18,39,37
"N00003660",285,15,26,14,12,18,3,12,52,28,40,13,50,43
"N00003661",272,6,38,25,13,27,2,4,45,31,27,21,41,36
"N00003662",162,6,24,14,10,7,0,6,21,11,15,11,27,40
"N00003663",215,2,44,27,17,24,1,1,22,19,16,14,43,31
"N00003664",351,20,24,16,8,26,7,13,74,41,40,26,55,45
"N00003665",333,15,26,15,11,25,5,10,51,31,64,22,50,49
"N00003666",366,17,35,25,10,28,0,17,46,33,63,21,63,60
"N00003667",289,15,17,13,4,13,1,14,51,33,58,14,37,51
"N00003668",300,8,13,10,3,19,0,8,39,43,63,16,46,53
"N00003669",309,10,24,15,9,26,2,8,44,37,53,22,51,42
"N00003670",300,27,12,11,1,31,4,23,52,26,51,13,46,42
"N00003671",222,3,32,25,7,16,3,0,13,19,19,17,51,52
"N00003672",202,10,13,10,3,13,2,8,30,24,27,14,39,32
"N00003673",176,5,16,13,3,5,2,3,21,23,28,13,31,34
"N00003674",293,19,16,12,4,20,4,15,43,29,53,21,44,48
"N00003675",222,10,15,7,8,19,2,8,37,25,30,18,36,32
"N00003676",206,9,32,24,8,9,3,6,23,12,13,22,38,48
"N00003677",208,3,42,29,13,23,2,1,16,15,7,19,41,42
"N00003678",282,4,34,27,7,26,1,3,25,15,13,28,58,79
"N00003679",234,8,30,22,8,21,3,5,34,21,11,19,36,54
"N00003680",185,12,32,22,10,13,1,11,18,17,10,14,34,35
"N00003681",288,15,32,27,5,17,2,13,43,23,20,27,55,56
"N00003682",167,4,25,19,6,9,2,2,19,13,9,8,33,47
"N00003683",267,11,47,34,13,12,1,10,37,30,20,19,45,46
"N00003684",236,4,38,26,12,27,0,4,24,20,19,21,39,44
"N00003685",253,11,23,14,9,25,3,8,42,29,22,18,37,46
"N00003686",245,7,32,21,11,27,1,6,23,29,26,11,44,46
"N00003687",334,16,22,13,9,37,2,14,46,40,43,23,57,50
"N00003688",258,4,33,25,8,15,0,4,25,28,19,18,44,72
"N00003689",197,6,35,23,12,9,0,6,19,16,6,16,28,62
"N00003690",370,16,21,17,4,28,6,10,64,39,76,28,47,51
"N00003691",309,11,18,11,7,32,1,10,46,35,74,16,42,35
"N00003692",279,14,9,7,2,20,4,10,54,17,66,19,40,40
"N00003693",295,9,21,10,11,26,2,7,36,34,50,24,40,55
"N00003694",348,14,13,6,7,34,2,12,46,31,85,21,56,48
"N00003695",294,15,18,12,6,30,1,14,43,34,43,20,39,52
"N00003696",288,16,13,10,3,18,6,10,37,19,59,28,53,45
"N00003697",334,24,25,15,10,50,5,19,53,30,39,18,36,59
"N00003698",447,39,28,18,10,45,6,33,78,43,69,21,52,72
"N00003699",283,28,24,13,11,37,6,22,76,28,26,11,24,29
"N00003700",307,31,22,12,10,39,6,25,53,24,42,14,37,45
"N00003701",434,35,14,8,6,51,6,29,87,45,73,24,51,54
"N00003702",546,79,26,16,10,56,12,67,145,66,68,21,44,41
"N00003703",403,50,19,13,6,39,15,35,88,49,50,25,30,53
"N00003704",318,20,20,10,10,21,3,17,61,41,49,18,46,42
"N00003705",321,6,26,18,8,20,2,4,60,40,50,18,52,49
"N00003706",351,21,34,22,12,31,4,17,51,47,49,15,42,61
"N00003707",408,25,38,15,23,59,5,20,69,38,65,20,50,44
"N00003708",370,22,38,25,13,45,4,18,56,37,53,23,38,58
"N00003709",283,14,29,13,16,34,3,11,32,29,24,21,48,52
"N00003710",321,15,45,36,9,30,4,11,40,33,28,26,51,53
"N00003711",368,30,23,15,8,32,4,26,80,38,49,36,34,46
"N00003712",278,17,24,16,8,17,6,11,72,30,27,17,40,34
"N00003713",274,13,34,18,16,34,2,11,42,31,20,16,47,37
"N00003714",286,7,47,34,13,33,2,5,28,34,22,21,41,53
"N00003715",212,5,29,17,12,10,1,4,27,20,10,23,51,37
"N00003716",235,15,25,13,12,12,4,11,41,18,18,18,47,41
"N00003717",213,14,22,10,12,12,1,13,38,19,22,17,28,41
"N00003718",1031,80,78,49,29,137,13,67,246,121,109,51,111,98
"N00003719",313,20,18,10,8,32,5,15,76,33,47,18,39,30
"N00003720",319,25,18,9,9,48,3,22,59,37,29,22,30,51
"N00003721",405,32,61,43,18,35,4,28,73,30,57,12,46,59
"N00003722",325,24,50,33,17,22,5,19,54,43,47,14,34,37
"N00003723",307,14,44,27,17,38,1,13,52,29,43,8,34,45
"N00003724",301,13,45,35,10,35,2,11,51,23,37,10,38,49
"N00003725",205,6,47,35,12,14,2,4,25,21,18,9,22,43
"N00003726",313,8,35,21,14,45,2,6,35,33,53,20,43,41
"N00003727",263,12,79,60,19,22,1,11,31,15,24,8,35,37
"N00003728",254,3,42,26,16,29,0,3,27,28,36,13,34,42
"N00003729",305,13,50,34,16,13,3,10,45,28,31,16,43,66
"N00003730",329,15,39,26,13,47,3,12,45,37,46,19,42,39
"N00003731",284,13,40,28,12,30,2,11,43,35,36,20,28,39
"N00003732",516,17,127,104,23,39,3,14,39,46,37,36,81,94
"N00003733",274,7,86,62,24,35,1,6,13,26,14,14,45,34
"N00003734",293,7,41,21,20,37,3,4,29,22,11,23,62,61
"N00003735",222,1,47,34,13,20,0,1,21,19,8,13,35,58
"N00003736",270,3,36,24,12,25,2,1,31,19,7,33,57,59
"N00003737",362,11,59,38,21,54,3,8,39,28,20,28,51,72
"N00003738",219,7,33,24,9,16,1,6,13,25,7,16,51,51
"N00003739",301,21,31,20,11,21,3,18,49,25,21,33,44,56
"N00003740",202,15,19,16,3,20,4,11,24,23,14,17,34,36
"N00003741",193,8,32,23,9,8,0,8,20,16,6,12,38,53
"N00003742",235,9,23,12,11,23,0,9,26,12,19,24,43,56
"N00003743",374,29,20,11,9,44,4,25,60,44,51,21,57,48
"N00003744",294,7,26,12,14,30,1,6,40,29,29,19,52,62
"N00003745",327,27,22,15,7,28,4,23,77,24,38,17,46,48
"N00003746",235,12,14,10,4,29,2,10,48,24,15,21,34,38
"N00003747",228,25,15,13,2,19,8,17,50,25,25,15,28,26
"N00003748",284,20,21,11,10,25,3,17,37,25,44,22,41,49
"N00003749",354,35,16,10,6,39,8,27,95,24,27,37,49,32
"N00003750",348,45,14,8,6,48,8,37,88,43,35,16,38,21
"N00003751",407,45,15,13,2,40,7,38,124,43,30,22,50,38
"N00003752",318,31,21,12,9,37,6,25,67,29,43,14,39,37
"N00003753",358,19,40,33,7,35,7,12,50,30,27,38,50,69
"N00003754",253,15,11,8,3,26,3,12,47,29,26,22,44,33
"N00003755",332,18,25,20,5,36,3,15,62,23,44,23,42,59
"N00003756",217,1,46,37,9,22,0,1,14,9,9,14,54,48
"N00003757",237,14,25,21,4,25,0,14,29,22,14,18,45,45
"N00003758",401,22,25,14,11,38,5,17,74,50,38,34,59,61
"N00003759",247,13,27,22,5,15,3,10,30,27,24,20,44,47
"N00003760",213,9,36,25,11,11,2,7,22,16,7,18,29,65
"N00003761",272,20,14,9,5,19,0,20,46,21,42,19,51,40
"N00003762",349,33,16,9,7,28,6,27,60,38,73,23,42,36
"N00003763",335,23,16,10,6,30,6,17,69,46,58,17,41,35
"N00003764",428,25,20,15,5,44,4,21,64,56,71,27,66,55
"N00003765",298,21,18,13,5,29,6,15,51,25,56,14,45,39
"N00003766",360,35,18,11,7,41,7,28,74,33,57,21,32,49
"N00003767",360,31,23,16,7,47,6,25,71,45,52,16,33,42
"N00003768",457,58,34,19,15,37,10,48,97,36,65,33,54,43
"N00003769",274,14,26,14,12,19,3,11,58,25,29,22,42,39
"N00003770",357,16,36,21,15,26,5,11,39,31,19,38,76,76
"N00003771",355,18,40,32,8,36,3,15,64,27,37,23,58,52
"N00003772",144,7,22,18,4,8,1,6,19,13,5,8,27,35
"N00003773",243,10,24,14,10,15,5,5,57,21,15,20,32,49
"N00003774",267,14,12,8,4,33,4,10,63,35,19,18,46,27
"N00003775",399,39,18,10,8,32,7,32,123,57,36,21,41,32
"N00003776",274,10,29,19,10,24,2,8,37,35,13,21,45,60
"N00003777",219,1,30,23,7,17,0,1,30,12,3,18,44,64
"N00003778",295,14,46,30,16,24,0,14,33,19,16,22,56,65
"N00003779",249,2,49,40,9,35,0,2,16,22,12,24,40,49
"N00003780",276,7,15,11,4,42,2,5,59,21,18,21,64,29
"N00003781",295,16,24,17,7,46,4,12,60,28,22,25,30,44
"N00003782",433,32,29,22,7,49,5,27,99,42,35,21,60,66
"N00003783",257,7,32,16,16,14,2,5,30,18,18,32,63,43
"N00003784",349,27,34,25,9,40,2,25,60,32,43,15,48,50
"N00003785",426,26,33,19,14,44,6,20,68,45,63,26,58,63
"N00003786",363,31,23,16,7,33,11,20,70,52,28,33,44,49
"N00003787",300,22,14,10,4,42,3,19,61,38,43,21,29,30
"N00003788",261,14,22,11,11,25,4,10,34,31,28,19,40,48
"N00003789",321,25,30,19,11,38,6,19,36,34,61,20,43,34
"N00003790",254,13,25,17,8,20,4,9,34,31,9,20,45,57
"N00003791",500,35,42,24,18,43,5,30,108,53,67,32,69,51
"N00003792",223,3,26,20,6,14,0,3,40,16,15,16,50,43
"N00003793",503,27,39,29,10,60,4,23,108,52,76,39,46,56
"N00003794",283,13,44,34,10,40,2,11,40,31,22,18,32,43
"N00003795",361,26,25,19,6,44,9,17,56,41,45,27,43,54
"N00003796",428,37,27,19,8,37,4,33,76,47,75,27,53,49
"N00003797",356,14,60,40,20,41,3,11,53,36,39,28,37,48
"N00003798",331,13,43,26,17,47,2,11,42,41,30,14,59,42
"N00003799",237,10,6,5,1,17,4,6,37,19,32,21,49,46
"N00003800",329,12,10,8,2,36,5,7,54,39,53,26,48,51
"N00003801",297,9,19,11,8,26,3,6,31,27,57,20,56,52
"N00003802",200,11,9,6,3,16,2,9,29,24,27,13,32,39
"N00003803",284,10,14,12,2,19,3,7,50,32,38,23,56,42
"N00003804",322,22,21,15,6,24,7,15,48,46,64,23,31,43
"N00003805",226,3,13,8,5,24,0,3,22,13,32,17,53,49
"N00003806",289,15,29,26,3,19,1,14,21,26,27,19,57,76
"N00003807",213,4,26,19,7,10,1,3,16,10,26,16,55,50
"N00003808",251,9,20,11,9,17,2,7,17,19,27,28,53,61
"N00003809",245,8,18,10,8,24,0,8,34,35,46,14,33,33
"N00003810",141,5,7,5,2,4,1,4,18,11,15,9,37,35
"N00003811",285,9,13,10,3,20,1,8,40,34,52,21,51,45
"N00003812",238,5,21,16,5,19,0,5,22,23,37,19,49,43
"N00003813",250,11,17,8,9,20,0,11,30,14,36,20,52,50
"N00003814",269,9,15,12,3,20,0,9,36,17,43,24,58,47
"N00003815",395,12,51,30,21,28,0,12,42,40,53,29,78,62
"N00003816",284,4,47,31,16,26,1,3,10,26,33,15,71,52
"N00003817",353,17,24,21,3,34,5,12,50,41,76,23,34,54
"N00003818",383,10,49,41,8,30,3,7,45,26,63,29,69,62
"N00003819",270,15,20,13,7,16,3,12,59,24,63,10,35,28
"N00003820",416,22,23,18,5,26,3,19,65,48,93,21,47,71
"N00003821",288,9,20,13,7,26,2,7,48,26,60,16,38,45
"N00003822",395,26,25,17,8,37,4,22,63,37,83,18,47,59
"N00003823",421,30,25,21,4,48,4,26,84,39,73,27,56,39
"N00003824",503,33,26,22,4,44,6,27,88,38,114,34,64,62
"N00003825",675,27,52,31,21,64,4,23,119,54,87,52,88,132
"N00003826",465,46,19,14,5,55,4,42,86,50,80,30,52,47
"N00003827",708,46,43,30,13,56,12,34,120,89,138,45,83,88
"N00003828",318,14,17,12,5,24,2,12,37,43,77,22,50,34
"N00003829",347,8,26,22,4,43,2,6,44,37,73,17,41,58
"N00003830",382,26,41,26,15,39,2,24,67,27,74,19,42,47
"N00003831",198,10,21,17,4,10,1,9,31,22,34,17,30,23
"N00003832",376,15,29,18,11,32,3,12,56,38,54,23,62,67
"N00003833",333,9,58,44,14,34,3,6,37,33,33,22,46,61
"N00003834",295,8,42,27,15,29,1,7,32,31,26,22,54,51
"N00003835",387,41,27,17,10,25,3,38,89,33,53,25,44,50
"N00003836",268,27,14,9,5,20,9,18,64,24,34,16,39,30
"N00003837",239,21,22,16,6,32,5,16,44,20,23,15,31,31
"N00003838",299,36,21,11,10,21,4,32,63,23,49,13,36,37
"N00003839",289,39,10,6,4,41,8,31,63,23,47,12,29,25
"N00003840",323,33,12,10,2,30,12,21,64,41,55,17,41,30
"N00003841",189,11,17,13,4,15,2,9,35,21,26,11,24,29
"N00003842",279,45,10,4,6,21,8,37,79,36,41,10,27,10
"N00003843",235,24,26,24,2,18,1,23,39,16,35,10,36,31
"N00003844",384,60,19,15,4,44,11,49,102,42,57,13,22,25
"N00003845",234,9,21,13,8,24,0,9,39,22,28,18,41,32
"N00003846",452,15,55,36,19,35,3,12,50,53,20,39,87,98
"N00003847",192,12,20,16,4,7,2,10,35,18,20,15,28,37
"N00003848",265,6,45,29,16,19,2,4,35,24,27,19,52,38
"N00003849",408,22,42,29,13,46,7,15,63,38,60,23,51,63
"N00003850",282,11,41,32,9,29,0,11,33,34,42,17,32,43
"N00003851",316,12,49,27,22,29,4,8,55,35,34,16,34,52
"N00003852",218,14,28,18,10,20,3,11,37,22,13,20,29,35
"N00003853",344,20,25,17,8,37,5,15,69,29,48,25,37,54
"N00003854",323,30,30,27,3,31,5,25,66,30,40,17,31,48
"N00003855",333,28,29,18,11,29,7,21,66,31,45,20,38,47
"N00003856",316,23,26,15,11,30,2,21,67,49,43,18,35,25
"N00003857",377,24,25,18,7,36,3,21,62,41,68,26,59,36
"N00003858",381,22,40,26,14,47,4,18,50,36,67,24,42,53
"N00003859",342,15,45,40,5,28,1,14,54,35,39,20,52,54
"N00003860",699,42,58,34,24,60,4,38,132,70,98,54,107,78
"N00003861",372,14,24,18,6,37,2,12,51,34,85,30,42,55
"N00003862",309,13,15,14,1,28,2,11,40,43,71,16,41,42
"N00003863",186,9,33,16,17,12,3,6,20,15,16,16,27,38
"N00003864",289,12,26,13,13,21,5,7,43,32,11,26,54,64
"N00003865",181,6,36,23,13,11,2,4,23,11,9,16,30,39
"N00003866",267,15,32,18,14,11,3,12,34,9,17,17,61,71
"N00003867",536,21,52,37,15,47,5,16,64,50,53,41,105,103
"N00003868",268,9,31,22,9,12,3,6,32,22,16,30,52,64
"N00003869",883,48,86,60,26,87,6,42,137,91,56,76,143,159
"N00003870",193,10,19,11,8,7,0,10,22,20,10,20,41,44
"N00003871",539,85,24,16,8,52,17,68,129,55,47,32,68,47
"N00003872",201,3,25,15,10,11,0,3,33,21,11,16,38,43
"N00003873",774,21,79,48,31,77,3,18,95,80,66,59,139,158
"N00003874",381,29,14,12,2,37,7,22,68,52,63,31,38,49
"N00003875",284,11,42,22,20,30,1,10,60,26,25,17,35,38
"N00003876",389,31,26,20,6,41,4,27,59,40,75,24,43,50
"N00003877",262,8,17,10,7,31,2,6,40,32,30,21,40,43
"N00003878",328,20,12,7,5,31,2,18,48,38,82,23,37,37
"N00003879",322,21,18,13,5,24,4,17,53,41,75,22,41,27
"N00003880",319,23,20,8,12,21,7,16,61,39,41,26,43,45
"N00003881",381,51,28,24,4,48,12,39,97,52,41,20,27,17
"N00003882",232,24,4,1,3,19,6,18,52,30,23,19,31,30
"N00003883",620,71,41,38,3,67,14,57,167,76,42,26,86,44
"N00003884",539,33,49,39,10,50,8,25,91,61,45,52,81,77
"N00003885",249,10,23,13,10,24,3,7,20,36,21,13,54,48
"N00003886",230,3,18,14,4,19,1,2,36,30,18,17,42,47
"N00003887",377,46,9,6,3,20,9,37,68,56,17,37,71,53
"N00003888",204,20,10,4,6,17,6,14,53,28,10,17,35,14
"N00003889",285,36,15,12,3,39,4,32,60,43,19,15,33,25
"N00003890",174,9,20,10,10,8,5,4,26,21,7,13,37,33
"N00003891",218,5,9,5,4,28,0,5,42,34,12,16,44,28
"N00003892",176,3,13,8,5,17,0,3,27,34,3,26,30,23
"N00003893",162,6,6,2,4,13,0,6,35,27,9,15,24,27
"N00003894",203,4,20,18,2,15,0,4,34,34,13,15,46,22
"N00003895",177,9,5,5,0,9,2,7,35,31,8,19,33,28
"N00003896",531,12,82,74,8,17,3,9,65,76,19,47,114,99
"N00003897",182,8,32,20,12,18,1,7,21,11,11,9,41,31
"N00003898",283,38,7,5,2,32,7,31,77,39,20,11,29,30
"N00003899",275,35,8,4,4,26,5,30,65,50,12,17,36,26
"N00003900",211,3,18,15,3,25,1,2,14,24,13,19,50,45
"N00003901",181,7,29,24,5,17,1,6,18,21,6,7,34,42
"N00003902",245,33,9,7,2,22,11,22,51,45,18,16,28,23
"N00003903",438,50,10,8,2,43,16,34,131,76,25,24,52,27
"N00003904",382,38,14,9,5,30,10,28,103,62,28,21,52,34
"N00003905",200,6,12,9,3,3,3,3,31,19,14,14,50,51
"N00003906",165,11,11,4,7,10,3,8,19,23,15,6,38,32
"N00003907",242,13,7,5,2,18,1,12,45,36,21,26,47,29
"N00003908",131,2,15,9,6,8,1,1,20,14,8,14,24,26
"N00003909",259,11,20,15,5,21,3,8,43,44,10,25,49,36
"N00003910",185,7,5,2,3,13,1,6,20,24,14,19,38,45
"N00003911",918,107,21,12,9,69,24,83,191,169,64,77,122,98
"N00003912",330,27,7,3,4,17,5,22,94,66,30,19,41,29
"N00003913",176,2,16,8,8,4,0,2,21,25,12,22,28,46
"N00003914",266,10,6,3,3,20,0,10,52,50,11,31,47,39
"N00003915",203,7,17,8,9,20,2,5,21,30,11,11,46,40
"N00003916",287,17,7,4,3,36,6,11,73,55,12,22,38,27
"N00003917",211,10,9,8,1,16,1,9,32,41,8,22,36,37
"N00003918",202,6,13,7,6,7,2,4,37,24,4,23,53,35
"N00003919",227,15,6,5,1,18,2,13,51,36,17,14,40,30
"N00003920",243,11,9,3,6,19,2,9,39,45,20,25,48,27
"N00003921",254,14,6,5,1,15,5,9,55,60,10,25,41,28
"N00003922",237,11,3,2,1,18,2,9,47,47,10,28,41,32
"N00003923",223,15,6,1,5,9,4,11,53,50,15,14,40,21
"N00003924",243,8,11,9,2,23,2,6,42,40,11,23,44,41
"N00003925",224,23,10,6,4,17,4,19,45,25,7,27,46,24
"N00003926",243,21,5,3,2,26,4,17,65,38,25,16,30,17
"N00003927",239,29,7,3,4,19,7,22,58,37,12,15,40,22
"N00003928",324,12,25,22,3,20,1,11,65,58,22,24,56,42
"N00003929",186,16,5,1,4,17,3,13,43,39,6,17,29,14
"N00003930",219,12,6,3,3,16,4,8,52,37,15,22,36,23
"N00003931",151,3,8,5,3,9,0,3,26,21,12,8,39,25
"N00003932",268,26,6,3,3,11,5,21,82,35,32,15,37,24
"N00003933",649,62,9,8,1,59,13,49,162,119,89,38,63,48
"N00003934",246,22,5,4,1,22,4,18,51,29,47,16,32,22
"N00003935",278,30,4,2,2,27,8,22,66,33,46,26,31,15
"N00003936",645,92,9,6,3,34,15,77,168,100,64,43,78,57
"N00003937",236,32,6,5,1,22,5,27,45,39,37,16,28,11
"N00003938",200,21,4,3,1,10,4,17,51,24,19,20,34,17
"N00003939",277,34,7,6,1,24,4,30,56,45,43,23,27,18
"N00003940",238,23,8,7,1,24,7,16,56,40,35,13,21,18
"N00003941",287,33,9,6,3,31,4,29,55,39,50,13,29,28
"N00003942",324,57,9,7,2,36,13,44,78,61,21,21,29,12
"N00003943",467,48,11,5,6,31,6,42,111,70,40,43,53,60
"N00003944",273,21,10,6,4,18,3,18,53,52,20,23,48,28
"N00003945",225,14,2,2,0,20,5,9,49,36,21,22,34,27
"N00003946",332,31,6,4,2,27,8,23,94,72,18,20,43,21
"N00003947",419,35,5,4,1,33,8,27,121,82,26,40,48,29
"N00003948",248,9,8,3,5,19,2,7,41,42,18,30,44,37
"N00003949",225,18,5,3,2,22,4,14,43,32,17,19,47,22
"N00003950",233,15,3,3,0,18,1,14,53,48,11,13,41,31
"N00003951",188,8,10,4,6,11,3,5,22,28,14,16,41,38
"N00003952",194,13,5,3,2,15,3,10,47,37,17,14,28,18
"N00003953",203,16,6,3,3,15,4,12,43,37,8,18,33,27
"N00003954",151,7,2,1,1,8,1,6,41,30,10,8,26,19
"N00003955",197,18,4,2,2,11,6,12,40,36,19,14,33,22
"N00003956",241,13,7,4,3,30,2,11,40,54,14,19,38,26
"N00003957",154,2,25,15,10,12,0,2,19,11,6,14,35,30
"N00003958",362,6,42,30,12,32,1,5,42,43,17,35,76,69
"N00003959",186,17,7,5,2,12,3,14,37,34,10,14,31,24
"N00003960",195,14,5,3,2,7,6,8,47,34,12,19,36,21
"N00003961",216,9,6,6,0,12,3,6,41,41,15,19,54,19
"N00003962",524,50,17,9,8,42,14,36,116,99,40,44,71,45
"N00003963",218,17,4,2,2,14,3,14,49,49,13,21,37,14
"N00003964",249,11,20,11,9,18,4,7,39,23,13,27,56,42
"N00003965",284,26,7,2,5,14,4,22,67,52,21,22,40,35
"N00003966",218,4,17,12,5,10,1,3,17,33,5,23,52,57
"N00003967",277,47,3,2,1,37,9,38,76,58,15,11,21,9
"N00003968",205,16,5,4,1,17,1,15,26,32,11,20,41,37
"N00003969",184,12,3,3,0,12,3,9,32,33,9,16,34,33
"N00003970",223,12,9,5,4,16,3,9,46,37,13,20,43,27
"N00003971",210,14,9,8,1,22,1,13,29,36,16,24,35,25
"N00003972",230,9,16,10,6,14,4,5,28,27,10,26,55,45
"N00003973",249,23,13,6,7,30,3,20,74,42,16,12,24,15
"N00003974",467,55,7,5,2,68,14,41,124,92,33,22,48,18
"N00003975",272,23,10,5,5,26,3,20,68,51,22,13,36,23
"N00003976",250,17,8,4,4,27,6,11,56,42,15,21,41,23
"N00003977",226,12,5,4,1,29,2,10,51,51,22,14,30,12
"N00003978",262,27,5,1,4,33,1,26,66,41,28,21,29,12
"N00003979",243,15,11,7,4,30,5,10,49,44,22,21,32,19
"N00003980",286,25,9,7,2,27,4,21,84,56,20,13,34,18
"N00003981",187,4,12,8,4,11,1,3,20,36,11,12,39,42
"N00003982",166,9,3,1,2,7,1,8,30,34,9,12,37,25
"N00003983",191,4,22,18,4,9,0,4,20,22,17,14,38,45
"N00003984",244,13,25,18,7,22,4,9,19,51,14,17,49,34
"N00003985",204,1,20,12,8,12,0,1,12,20,3,18,60,58
"N00003986",165,1,12,7,5,4,0,1,16,23,8,18,40,43
"N00003987",191,2,21,19,2,15,1,1,20,18,7,14,49,45
"N00003988",205,4,16,13,3,11,1,3,17,20,17,26,50,44
"N00003989",134,3,20,11,9,4,2,1,9,19,5,11,34,29
"N00003990",324,42,8,4,4,23,11,31,93,59,24,21,34,20
"N00003991",216,14,21,13,8,11,4,10,28,33,14,22,34,39
"N00003992",266,35,5,4,1,17,8,27,57,47,28,18,32,27
"N00003993",304,40,9,6,3,25,9,31,74,40,36,29,31,20
"N00003994",277,39,6,3,3,32,6,33,60,55,32,17,24,12
"N00003995",290,24,4,3,1,23,3,21,49,49,70,16,36,19
"N00003996",245,12,15,8,7,9,2,10,42,38,20,28,42,39
"N00003997",265,47,4,3,1,20,14,33,72,35,24,24,22,17
"N00003998",256,21,5,3,2,19,7,14,52,55,18,19,38,29
"N00003999",267,19,8,5,3,14,3,16,55,48,32,32,32,27
"N00004000",204,7,18,10,8,8,1,6,23,21,10,21,49,47
"N00004001",236,6,23,12,11,26,0,6,18,21,13,22,48,59
"N00004002",193,5,20,18,2,8,2,3,21,24,7,17,40,51
"N00004003",289,7,26,18,8,19,2,5,38,35,15,15,70,64
"N00004004",180,5,19,12,7,10,3,2,13,12,10,17,52,42
"N00004005",132,2,16,14,2,8,1,1,21,17,2,14,27,25
"N00004006",162,3,12,9,3,9,1,2,14,14,5,21,49,35
"N00004007",182,1,25,17,8,20,1,0,10,22,5,21,41,37
"N00004008",304,25,13,8,5,35,5,20,57,51,29,23,42,29
"N00004009",221,18,11,7,4,18,3,15,59,37,14,19,29,16
"N00004010",290,27,5,3,2,23,1,26,45,48,19,18,58,47
"N00004011",316,22,13,9,4,33,1,21,78,58,11,22,48,31
"N00004012",235,20,9,7,2,16,8,12,49,41,15,15,43,27
"N00004013",242,20,6,4,2,29,4,16,53,33,17,19,44,21
"N00004014",280,40,5,3,2,29,8,32,60,48,18,16,41,23
"N00004015",225,18,9,6,3,23,3,15,56,37,14,15,34,19
"N00004016",288,31,9,4,5,21,4,27,71,50,13,21,50,22
"N00004017",199,14,7,2,5,19,3,11,31,42,12,15,37,22
"N00004018",217,25,5,3,2,17,7,18,42,37,19,13,37,22
"N00004019",235,20,7,2,5,33,5,15,43,48,13,16,28,27
"N00004020",290,11,14,9,5,34,1,10,62,44,10,16,64,35
"N00004021",221,16,2,0,2,21,5,11,55,42,14,14,28,29
"N00004022",214,9,32,17,15,15,4,5,31,32,4,12,41,38
"N00004023",180,13,8,6,2,9,0,13,27,27,10,16,37,33
"N00004024",223,9,16,12,4,15,3,6,25,29,11,18,58,42
"N00004025",305,10,20,14,6,25,2,8,43,52,16,24,59,56
"N00004026",252,22,9,4,5,13,2,20,44,64,19,19,35,27
"N00004027",239,13,9,5,4,18,5,8,45,51,19,21,41,22
"N00004028",223,11,10,7,3,19,6,5,34,36,8,22,46,37
"N00004029",230,20,11,7,4,11,4,16,45,45,17,25,40,16
"N00004030",210,18,0,0,0,10,4,14,51,44,14,18,28,27
"N00004031",203,5,17,13,4,12,1,4,30,27,7,16,55,34
"N00004032",154,8,6,3,3,12,2,6,24,21,12,12,35,24
"N00004033",191,2,16,12,4,16,0,2,20,26,11,18,49,33
"N00004034",170,7,4,2,2,4,1,6,32,28,13,11,42,29
"N00004035",202,18,3,2,1,10,6,12,40,40,16,20,34,21
"N00004036",175,9,4,0,4,8,4,5,37,24,10,19,35,29
"N00004037",213,13,10,3,7,15,5,8,42,51,18,10,30,24
"N00004038",185,8,8,5,3,12,2,6,29,31,8,23,38,28
"N00004039",198,23,6,4,2,20,1,22,44,39,12,12,30,12
"N00004040",211,12,4,2,2,15,4,8,54,31,21,17,34,23
"N00004041",219,17,6,4,2,21,1,16,41,39,11,17,45,22
"N00004042",438,31,9,5,4,44,6,25,114,93,20,40,54,33
"N00004043",246,33,4,4,0,20,9,24,46,43,16,21,36,27
"N00004044",203,17,7,4,3,21,2,15,40,38,15,15,32,18
"N00004045",258,21,12,10,2,21,3,18,42,48,15,19,52,28
"N00004046",220,4,10,9,1,24,1,3,22,31,16,28,47,38
"N00004047",768,131,10,7,3,111,29,102,228,124,45,29,62,28
"N00004048",343,53,10,3,7,43,11,42,109,47,35,14,25,7
"N00004049",345,53,5,3,2,23,13,40,120,59,17,21,35,12
"N00004050",675,141,10,9,1,65,29,112,222,112,37,25,44,19
"N00004051",720,178,16,8,8,112,37,141,194,98,53,24,31,14
"N00004052",251,52,3,1,2,23,15,37,82,47,18,7,16,3
"N00004053",224,22,5,5,0,16,7,15,45,39,24,13,29,31
"N00004054",360,30,8,5,3,35,11,19,85,75,31,29,41,26
"N00004055",177,8,5,4,1,8,0,8,22,38,23,18,29,26
"N00004056",308,31,7,5,2,38,9,22,73,49,29,22,28,31
"N00004057",288,31,6,3,3,35,9,22,84,46,28,11,28,19
"N00004058",876,102,11,6,5,73,28,74,246,145,78,50,99,72
"N00004059",1054,164,22,9,13,86,22,142,315,159,78,72,91,67
"N00004060",885,108,24,14,10,75,20,88,236,156,56,56,109,65
"N00004061",442,39,8,6,2,62,13,26,98,87,38,23,50,37
"N00004062",367,57,5,4,1,47,10,47,105,59,29,22,26,17
"N00004063",641,73,10,8,2,70,18,55,152,125,40,39,89,43
"N00004064",462,64,11,6,5,52,16,48,115,95,26,22,55,22
"N00004065",158,0,28,18,10,7,0,0,16,24,3,9,36,35
"N00004066",199,4,11,7,4,13,0,4,29,32,12,17,39,42
"N00004067",171,2,21,12,9,12,0,2,20,18,8,11,47,32
"N00004068",216,2,15,11,4,15,0,2,26,29,9,23,53,44
"N00004069",184,6,21,11,10,13,0,6,12,22,5,20,33,52
"N00004070",172,2,9,4,5,10,0,2,16,21,9,19,40,46
"N00004071",193,7,23,12,11,14,0,7,22,22,10,11,44,40
"N00004072",223,11,16,10,6,15,2,9,18,25,8,24,54,52
"N00004073",761,71,16,12,4,85,11,60,153,138,56,53,115,74
"N00004074",229,17,5,3,2,17,3,14,46,39,12,20,41,32
"N00004075",349,39,5,4,1,48,11,28,89,60,20,26,43,19
"N00004076",232,12,10,5,5,23,3,9,41,39,9,20,47,31
"N00004077",266,12,7,5,2,15,1,11,42,54,19,30,55,32
"N00004078",218,11,9,3,6,11,3,8,28,38,11,25,50,35
"N00004079",216,16,17,13,4,9,4,12,35,39,14,18,30,38
"N00004080",218,6,32,22,10,21,3,3,24,17,8,18,55,37
"N00004081",226,9,7,5,2,17,3,6,36,41,14,16,50,36
"N00004082",271,7,15,11,4,23,1,6,37,41,13,24,64,47
"N00004083",226,9,29,20,9,19,4,5,14,34,10,15,46,50
"N00004084",211,49,7,5,2,15,6,43,60,34,12,4,20,10
"N00004085",656,91,40,26,14,89,17,74,145,70,28,38,74,81
"N00004086",183,5,19,12,7,9,1,4,24,19,6,17,43,41
"N00004087",606,78,16,10,6,204,13,65,101,64,29,24,48,42
"N00004088",264,58,7,4,3,17,3,55,92,36,14,10,17,13
"N00004089",203,42,4,1,3,23,6,36,68,27,15,2,15,7
"N00004090",891,76,7,6,1,612,9,67,90,39,30,9,16,12
"N00004091",839,55,13,13,0,606,4,51,83,30,17,7,20,8
"N00004092",192,13,6,4,2,17,2,11,48,41,8,18,28,13
"N00004093",272,22,11,3,8,15,5,17,65,43,15,19,54,28
"N00004094",402,24,38,28,10,37,5,19,58,57,17,35,68,68
"N00004095",220,3,31,21,10,16,1,2,21,19,10,14,58,48
"N00004096",183,5,27,14,13,16,0,5,13,15,2,20,45,40
"N00004097",349,7,52,33,19,41,1,6,39,42,10,22,70,66
"N00004098",207,3,28,21,7,14,0,3,15,18,9,23,54,43
"N00004099",422,23,25,10,15,23,4,19,103,67,18,37,78,48
"N00004100",233,10,29,17,12,22,3,7,20,31,13,26,41,41
"N00004101",152,9,19,12,7,9,2,7,31,16,5,10,28,25
"N00004102",232,6,24,13,11,10,1,5,41,31,10,20,54,36
"N00004103",143,1,15,9,6,3,1,0,15,15,9,20,33,32
"N00004104",132,6,6,3,3,14,1,5,20,25,8,11,26,16
"N00004105",170,4,22,17,5,4,1,3,13,16,14,21,35,41
"N00004106",180,3,15,11,4,8,1,2,25,26,5,13,44,41
"N00004107",149,11,6,4,2,10,3,8,29,21,12,14,23,23
"N00004108",186,6,26,23,3,9,1,5,21,25,3,15,40,41
"N00004109",174,9,10,6,4,13,1,8,28,23,19,11,38,23
"N00004110",235,18,2,0,2,17,4,14,55,37,16,27,42,21
"N00004111",295,37,8,6,2,25,10,27,95,60,25,12,25,8
"N00004112",331,42,7,4,3,31,18,24,103,60,27,12,33,16
"N00004113",501,61,10,8,2,44,19,42,155,109,34,24,52,12
"N00004114",222,20,5,3,2,13,10,10,54,42,17,19,35,17
"N00004115",292,28,6,4,2,35,7,21,59,51,24,25,54,10
"N00004116",502,62,10,5,5,67,17,45,128,103,44,23,48,17
"N00004117",366,51,5,4,1,52,10,41,109,61,29,14,32,13
"N00004118",236,24,5,4,1,23,4,20,57,44,19,17,34,13
"N00004119",238,16,4,1,3,15,5,11,65,52,14,13,42,17
"N00004120",170,12,15,9,6,12,3,9,38,34,12,13,27,7
"N00004121",285,31,5,4,1,36,5,26,73,44,10,23,48,15
"N00004122",293,26,6,3,3,41,9,17,83,50,24,21,26,16
"N00004123",261,48,11,6,5,25,11,37,80,30,28,9,23,7
"N00004124",219,27,10,3,7,13,7,20,64,45,25,6,20,9
"N00004125",260,41,5,2,3,22,10,31,76,31,35,11,26,13
"N00004126",197,17,4,0,4,24,4,13,72,28,21,6,15,10
"N00004127",221,48,4,3,1,19,10,38,83,26,22,4,10,5
"N00004128",260,64,2,1,1,26,7,57,90,25,31,5,10,7
"N00004129",220,51,3,3,0,22,7,44,72,27,19,8,13,5
"N00004130",210,36,6,2,4,12,5,31,85,20,22,2,19,8
"N00004131",204,15,3,3,0,12,3,12,73,31,20,7,30,13
"N00004132",236,27,5,2,3,19,8,19,78,47,13,9,28,10
"N00004133",230,11,5,2,3,24,2,9,50,50,14,20,40,16
"N00004134",257,22,6,5,1,17,2,20,82,47,15,20,35,13
"N00004135",258,15,8,4,4,21,3,12,74,43,18,21,39,19
"N00004136",323,45,5,2,3,31,9,36,88,55,31,21,32,15
"N00004137",302,39,7,3,4,32,6,33,93,62,24,7,30,8
"N00004138",262,13,5,3,2,21,1,12,63,44,20,21,51,24
"N00004139",526,50,13,4,9,32,16,34,134,130,37,34,67,29
"N00004140",312,39,4,2,2,26,5,34,107,52,13,21,38,12
"N00004141",220,16,5,0,5,21,3,13,55,48,15,14,35,11
"N00004142",238,27,9,6,3,20,4,23,57,45,13,14,35,18
"N00004143",261,19,9,7,2,26,9,10,68,44,20,15,47,13
"N00004144",423,31,16,10,6,43,6,25,80,72,25,36,89,31
"N00004145",228,12,12,5,7,19,2,10,56,37,19,18,39,16
"N00004146",266,27,10,4,6,24,8,19,61,52,14,22,40,16
"N00004147",257,25,9,4,5,22,5,20,52,42,14,28,51,14
"N00004148",145,5,37,33,4,11,1,4,11,20,12,8,19,22
"N00004149",207,23,4,2,2,15,3,20,47,50,14,12,30,12
"N00004150",357,39,12,7,5,19,5,34,82,61,35,23,62,24
"N00004151",210,16,6,1,5,11,5,11,49,48,16,12,41,11
"N00004152",161,8,7,4,3,14,1,7,39,33,10,12,23,15
"N00004153",281,31,13,8,5,20,10,21,72,47,22,17,48,11
"N00004154",205,14,5,4,1,18,4,10,67,28,19,11,33,10
"N00004155",220,23,16,7,9,16,1,22,43,29,13,19,34,27
"N00004156",163,5,18,9,9,8,0,5,18,24,11,18,34,27
"N00004157",363,29,14,5,9,36,3,26,72,75,13,26,62,36
"N00004158",327,30,8,4,4,25,6,24,95,55,24,21,49,20
"N00004159",82,5,7,3,4,7,2,3,17,11,6,5,14,10
"N00004160",146,2,12,6,6,5,0,2,21,16,6,10,39,35
"N00004161",185,9,19,16,3,16,3,6,23,23,14,16,36,29
"N00004162",137,4,19,11,8,8,1,3,16,14,4,6,42,24
"N00004163",287,36,9,3,6,26,10,26,75,49,19,23,35,15
"N00004164",308,27,7,3,4,35,1,26,77,63,18,23,33,25
"N00004165",288,22,9,5,4,19,4,18,61,58,25,18,52,24
"N00004166",203,8,10,5,5,17,2,6,48,31,20,18,31,20
"N00004167",266,11,25,14,11,16,3,8,47,47,9,18,55,38
"N00004168",142,2,16,9,7,7,0,2,26,8,6,20,29,28
"N00004169",250,23,15,8,7,23,1,22,57,59,14,12,33,14
"N00004170",222,28,3,1,2,16,1,27,69,39,21,15,20,11
"N00004171",236,40,10,5,5,11,9,31,70,53,14,8,21,9
"N00004172",176,12,4,2,2,11,3,9,61,30,10,13,24,11
"N00004173",203,23,7,4,3,9,3,20,54,28,17,14,35,16
"N00004174",188,32,5,2,3,11,8,24,66,23,25,3,16,7
"N00004175",209,29,7,3,4,18,7,22,62,34,23,9,16,11
"N00004176",224,40,6,5,1,14,5,35,67,39,20,8,18,12
"N00004177",92,12,2,1,1,6,5,7,32,16,1,3,14,6
"N00004178",213,23,4,2,2,26,10,13,56,46,19,11,17,11
"N00004179",240,18,3,2,1,28,6,12,67,51,22,12,27,12
"N00004180",211,29,5,3,2,11,6,23,74,47,13,5,17,10
"N00004181",200,26,7,5,2,21,5,21,64,31,16,9,20,6
"N00004182",255,36,3,3,0,23,9,27,80,36,18,11,29,19
"N00004183",71,4,4,1,3,0,1,3,12,9,5,5,22,10
"N00004184",166,17,4,0,4,15,2,15,46,27,18,10,20,9
"N00004185",523,39,16,15,1,37,8,31,160,108,21,37,71,34
"N00004186",210,18,10,2,8,18,2,16,48,43,23,9,28,13
"N00004187",223,23,5,5,0,9,7,16,69,44,15,11,21,26
"N00004188",216,23,9,5,4,17,3,20,57,40,18,16,26,10
"N00004189",143,9,2,2,0,4,0,9,39,30,13,13,16,17
"N00004190",293,15,7,2,5,18,4,11,60,63,18,34,47,31
"N00004191",435,56,13,8,5,27,14,42,127,72,41,22,60,17
"N00004192",220,14,8,3,5,17,2,12,45,36,20,20,37,23
"N00004193",187,29,2,0,2,13,3,26,67,30,16,5,17,8
"N00004194",184,21,5,2,3,16,8,13,63,31,16,9,17,6
"N00004195",202,7,14,9,5,16,1,6,24,21,9,18,46,47
"N00004196",688,91,10,5,5,49,18,73,183,131,51,51,81,41
"N00004197",160,3,16,11,5,8,3,0,18,24,11,13,38,29
"N00004198",168,5,17,7,10,12,1,4,14,11,9,18,53,29
"N00004199",568,44,12,8,4,54,11,33,122,103,45,53,94,41
"N00004200",260,25,1,0,1,23,4,21,87,59,21,13,22,9
"N00004201",248,25,7,4,3,29,5,20,69,46,16,17,30,9
"N00004202",259,20,3,1,2,18,3,17,54,53,14,26,45,26
"N00004203",243,16,16,11,5,11,6,10,39,35,22,25,58,21
"N00004204",249,9,4,3,1,23,4,5,36,42,19,21,63,32
"N00004205",212,6,7,5,2,17,1,5,28,31,17,27,48,31
"N00004206",180,4,21,9,12,19,1,3,13,23,8,15,47,30
"N00004207",238,25,14,8,6,19,6,19,63,37,17,11,27,25
"N00004208",344,16,25,15,10,15,5,11,50,52,27,36,85,38
"N00004209",482,44,19,13,6,39,9,35,129,93,44,18,68,28
"N00004210",232,15,15,7,8,12,2,13,37,26,20,28,47,32
"N00004211",532,66,9,6,3,24,12,54,141,118,40,32,64,38
"N00004212",1412,148,32,20,12,89,29,119,408,281,130,104,161,59
"N00004213",229,5,20,11,9,19,0,5,22,25,14,19,60,45
"N00004214",211,2,20,13,7,16,0,2,13,23,12,28,61,36
"N00004215",226,7,7,1,6,21,0,7,49,32,20,19,45,26
"N00004216",315,11,25,13,12,20,3,8,37,51,18,31,77,45
"N00004217",179,5,12,8,4,14,2,3,26,19,10,12,57,24
"N00004218",200,6,29,23,6,13,2,4,25,20,8,20,45,34
"N00004219",247,64,5,4,1,30,14,50,71,21,36,5,7,8
"N00004220",225,44,10,8,2,27,10,34,60,23,19,10,22,10
"N00004221",261,63,6,3,3,31,19,44,66,30,38,3,17,7
"N00004222",253,49,3,1,2,30,9,40,70,37,28,8,16,12
"N00004223",186,21,5,2,3,11,4,17,42,17,42,13,24,11
"N00004224",216,44,8,5,3,23,10,34,77,27,23,1,12,1
"N00004225",205,32,7,5,2,21,10,22,60,42,13,10,14,6
"N00004226",334,40,52,48,4,36,7,33,113,25,16,15,32,5
"N00004227",205,36,4,1,3,7,9,27,73,39,22,8,8,8
"N00004228",504,105,8,2,6,24,17,88,147,77,62,22,40,19
"N00004229",237,55,3,2,1,16,10,45,65,35,27,3,27,6
"N00004230",213,33,1,0,1,18,6,27,84,33,24,6,7,7
"N00004231",214,64,3,3,0,10,12,52,71,34,21,2,7,2
"N00004232",180,33,1,1,0,13,5,28,57,34,17,3,16,6
"N00004233",227,31,2,2,0,8,11,20,94,35,19,12,22,4
"N00004234",190,38,7,5,2,12,5,33,56,39,16,4,10,8
"N00004235",223,40,5,2,3,16,8,32,78,30,30,5,13,6
"N00004236",215,54,7,5,2,21,14,40,69,27,21,5,9,2
"N00004237",197,54,3,3,0,15,10,44,62,19,25,4,13,2
"N00004238",254,54,8,4,4,27,11,43,85,29,27,3,12,9
"N00004239",209,42,1,1,0,16,8,34,83,29,11,5,17,5
"N00004240",223,36,2,2,0,19,5,31,67,36,24,6,20,13
"N00004241",212,35,2,2,0,17,7,28,65,34,17,12,23,7
"N00004242",259,64,11,4,7,22,9,55,78,28,32,6,13,5
"N00004243",197,4,24,13,11,11,1,3,25,24,7,19,52,31
"N00004244",138,4,13,6,7,11,2,2,11,12,9,14,41,23
"N00004245",268,31,11,5,6,10,5,26,61,50,18,16,48,23
"N00004246",240,15,7,3,4,23,1,14,70,38,15,17,35,20
"N00004247",253,22,4,1,3,16,11,11,38,46,17,21,63,26
"N00004248",173,5,23,9,14,6,1,4,12,29,13,10,32,43
"N00004249",186,10,5,3,2,5,3,7,35,32,19,12,41,27
"N00004250",187,8,13,11,2,11,2,6,20,23,15,15,41,41
"N00004251",217,4,23,12,11,16,2,2,33,31,10,20,36,44
"N00004252",246,17,5,2,3,19,1,16,69,55,20,13,32,16
"N00004253",228,26,8,6,2,13,2,24,65,44,19,10,35,8
"N00004254",219,28,9,4,5,15,4,24,46,35,38,13,17,18
"N00004255",163,17,5,3,2,4,6,11,46,41,6,13,26,5
"N00004256",666,88,12,7,5,32,20,68,200,106,77,36,72,43
"N00004257",146,15,2,1,1,3,5,10,51,30,17,10,12,6
"N00004258",225,10,11,5,6,12,2,8,40,30,25,21,48,28
"N00004259",158,22,5,2,3,11,3,19,32,18,12,18,24,16
"N00004260",245,34,3,1,2,8,5,29,65,52,19,15,35,14
"N00004261",186,15,8,5,3,10,2,13,31,39,14,15,39,15
"N00004262",233,11,21,13,8,16,1,10,41,33,9,22,45,35
"N00004263",190,13,21,5,16,5,1,12,26,28,15,17,37,28
"N00004264",440,21,29,10,19,27,2,19,104,60,31,41,76,51
"N00004265",177,10,11,4,7,12,3,7,30,33,13,22,35,11
"N00004266",242,38,4,3,1,22,8,30,88,38,22,6,19,5
"N00004267",433,50,14,5,9,32,10,40,120,62,43,31,50,31
"N00004268",240,31,12,7,5,25,7,24,75,21,23,14,26,13
"N00004269",242,20,14,9,5,22,2,18,59,49,15,16,30,17
"N00004270",394,32,7,4,3,18,7,25,113,136,23,12,31,22
"N00004271",212,16,12,9,3,17,7,9,38,29,16,19,41,24
"N00004272",206,19,10,6,4,20,2,17,68,27,12,10,23,17
"N00004273",252,51,12,9,3,19,8,43,70,28,14,12,25,21
"N00004274",226,27,7,5,2,16,4,23,58,34,12,14,25,33
"N00004275",219,37,9,4,5,18,6,31,57,36,14,12,19,17
"N00004276",319,79,7,5,2,35,5,74,91,38,31,13,18,7
"N00004277",214,46,3,1,2,10,7,39,80,29,15,4,17,10
"N00004278",197,9,6,4,2,18,1,8,43,33,9,13,38,28
"N00004279",243,54,5,4,1,16,8,46,83,37,23,8,11,6
"N00004280",227,47,8,6,2,14,8,39,83,18,16,6,24,11
"N00004281",298,75,9,3,6,20,14,61,102,35,26,2,20,9
"N00004282",169,10,26,15,11,9,3,7,21,21,12,9,31,30
"N00004283",244,36,7,4,3,23,7,29,76,35,18,11,27,11
"N00004284",283,55,2,1,1,20,14,41,87,54,23,11,21,10
"N00004285",242,61,18,17,1,27,10,51,66,24,19,5,15,7
"N00004286",229,59,5,4,1,18,17,42,62,35,25,8,8,9
"N00004287",436,16,36,27,9,40,5,11,61,55,24,43,94,67
"N00004288",151,9,17,9,8,7,4,5,20,19,4,15,30,30
"N00004289",162,8,11,6,5,8,1,7,23,21,12,17,40,22
"N00004290",387,25,29,17,12,26,4,21,78,54,31,21,70,53
"N00004291",269,29,8,4,4,19,7,22,67,51,16,25,39,15
"N00004292",140,6,8,5,3,10,3,3,22,16,10,16,28,24
"N00004293",170,19,8,3,5,8,2,17,52,23,14,13,26,7
"N00004294",733,50,18,8,10,16,39,11,225,279,7,44,62,32
"N00004295",181,31,5,3,2,10,5,26,60,34,10,5,20,6
"N00004296",202,24,4,4,0,17,7,17,55,42,14,10,24,12
"N00004297",252,43,24,19,5,20,7,36,74,25,26,8,22,10
"N00004298",285,56,6,5,1,26,6,50,106,40,26,8,11,6
"N00004299",397,60,32,28,4,38,9,51,116,59,41,10,31,10
"N00004300",109,12,1,1,0,5,5,7,28,23,12,4,15,9
"N00004301",252,58,5,2,3,26,5,53,95,23,23,4,17,1
"N00004302",329,64,23,22,1,39,14,50,82,38,41,9,21,12
"N00004303",216,15,5,3,2,16,0,15,35,29,9,27,43,37
"N00004304",248,32,3,2,1,17,9,23,72,60,16,14,25,9
"N00004305",194,10,2,2,0,13,3,7,40,33,13,18,42,23
"N00004306",307,18,20,8,12,11,3,15,42,44,24,30,72,46
"N00004307",195,8,9,6,3,17,1,7,30,26,8,18,58,21
"N00004308",207,13,5,3,2,20,3,10,34,34,10,23,34,34
"N00004309",169,11,3,2,1,11,4,7,29,36,12,10,32,25
"N00004310",175,9,4,1,3,9,1,8,45,30,8,15,34,21
"N00004311",165,7,12,6,6,7,0,7,25,34,13,16,27,24
"N00004312",240,7,6,1,5,22,2,5,42,39,17,16,57,34
"N00004313",225,14,37,31,6,11,3,11,41,27,8,27,36,24
"N00004314",483,45,18,10,8,22,14,31,130,90,24,36,87,31
"N00004315",172,12,16,10,6,21,3,9,28,9,12,12,31,31
"N00004316",212,14,7,3,4,21,2,12,39,36,15,22,37,21
"N00004317",194,8,8,5,3,11,0,8,38,35,13,19,38,24
"N00004318",186,11,5,4,1,18,4,7,32,38,19,19,27,17
"N00004319",227,12,6,2,4,13,0,12,45,43,18,16,49,25
"N00004320",286,28,28,20,8,11,4,24,49,40,28,17,52,33
"N00004321",502,60,10,5,5,43,12,48,142,107,33,29,61,17
"N00004322",246,16,10,5,5,15,3,13,58,39,16,21,51,20
"N00004323",272,26,8,7,1,11,8,18,62,51,13,12,55,34
"N00004324",162,16,7,4,3,8,5,11,55,24,7,7,23,15
"N00004325",195,11,6,1,5,10,1,10,56,42,12,11,34,13
"N00004326",210,19,4,3,1,12,4,15,50,37,19,14,29,26
"N00004327",206,8,10,4,6,16,2,6,58,28,19,12,44,11
"N00004328",217,18,2,1,1,14,5,13,45,53,13,16,35,21
"N00004329",207,1,16,11,5,14,1,0,24,35,8,24,52,33
"N00004330",217,14,7,1,6,23,1,13,46,42,17,18,32,18
"N00004331",212,20,15,9,6,14,1,19,38,34,21,15,36,19
"N00004332",218,13,11,9,2,13,4,9,41,45,13,20,32,30
"N00004333",194,11,21,14,7,11,7,4,24,25,16,15,44,27
"N00004334",170,8,9,5,4,8,1,7,19,18,11,13,44,40
"N00004335",156,5,13,6,7,9,0,5,21,23,10,20,30,25
"N00004336",216,5,31,18,13,21,0,5,24,22,13,20,48,32
"N00004337",164,5,16,9,7,18,0,5,21,21,11,11,27,34
"N00004338",264,16,19,13,6,25,3,13,62,28,43,15,22,34
"N00004339",360,46,16,9,7,35,7,39,68,36,58,22,42,37
"N00004340",298,19,16,13,3,32,2,17,53,41,64,17,32,24
"N00004341",313,22,15,13,2,32,4,18,51,37,62,26,37,31
"N00004342",495,30,47,33,14,55,11,19,64,44,62,35,79,79
"N00004343",211,13,24,23,1,24,3,10,31,25,12,16,33,33
"N00004344",206,12,24,21,3,15,1,11,43,25,18,13,33,23
"N00004345",296,33,40,35,5,30,6,27,66,33,10,17,29,38
"N00004346",275,23,24,19,5,35,2,21,46,29,15,12,45,46
"N00004347",317,40,19,12,7,39,7,33,70,42,29,18,35,25
"N00004348",146,5,22,16,6,7,1,4,14,18,5,17,29,29
"N00004349",197,6,43,31,12,15,1,5,20,14,11,13,35,40
"N00004350",810,57,69,59,10,58,8,49,166,83,147,42,98,90
"N00004351",369,19,26,18,8,29,2,17,56,45,70,34,48,42
"N00004352",418,44,28,15,13,53,7,37,86,28,91,18,33,37
"N00004353",341,27,13,10,3,29,3,24,80,28,76,30,29,29
"N00004354",268,16,16,15,1,26,2,14,41,28,49,22,33,37
"N00004355",281,15,9,7,2,16,2,13,80,34,28,18,46,35
"N00004356",224,4,42,37,5,20,0,4,29,13,18,13,33,52
"N00004357",1025,57,91,63,28,98,13,44,205,105,71,73,182,143
"N00004358",236,12,23,18,5,22,3,9,43,28,15,20,38,35
"N00004359",743,47,62,44,18,49,14,33,151,79,66,60,120,109
"N00004360",335,41,17,11,6,22,4,37,76,50,24,24,40,41
"N00004361",388,12,58,44,14,21,2,10,48,42,30,30,66,81
"N00004362",487,45,30,25,5,31,9,36,114,70,53,24,66,54
"N00004363",340,24,24,14,10,35,7,17,56,40,61,24,33,43
"N00004364",303,18,12,11,1,28,5,13,47,38,57,21,40,42
"N00004365",347,9,42,33,9,39,4,5,58,24,39,22,62,52
"N00004366",212,2,33,21,12,18,0,2,22,21,18,15,27,56
"N00004367",494,35,50,40,10,47,4,31,68,50,87,27,60,70
"N00004368",344,17,13,11,2,38,1,16,82,36,54,23,44,37
"N00004369",287,12,26,21,5,36,2,10,35,24,44,16,40,54
"N00004370",417,22,49,38,11,41,2,20,71,38,62,19,45,70
"N00004371",322,24,17,14,3,35,3,21,89,22,58,14,37,26
"N00004372",340,16,34,24,10,50,2,14,58,37,49,16,40,40
"N00004373",337,19,27,22,5,48,6,13,61,27,51,28,35,41
"N00004374",329,14,36,24,12,19,2,12,43,30,72,24,44,47
"N00004375",616,26,89,60,29,56,5,21,84,55,69,27,99,111
"N00004376",328,15,31,23,8,28,2,13,42,33,64,21,48,46
"N00004377",331,22,31,29,2,34,4,18,44,29,66,18,45,42
"N00004378",180,8,30,22,8,13,1,7,18,11,16,15,30,39
"N00004379",201,4,20,13,7,23,0,4,32,31,8,21,34,28
"N00004380",221,12,6,4,2,22,1,11,52,39,19,10,36,25
"N00004381",236,11,10,8,2,17,1,10,49,36,13,25,42,33
"N00004382",330,18,75,65,10,25,2,16,56,34,16,15,46,45
"N00004383",207,13,11,10,1,14,2,11,28,34,9,21,40,37
"N00004384",192,4,14,10,4,9,0,4,39,26,18,18,34,30
"N00004385",212,17,8,4,4,22,1,16,61,28,16,15,22,23
"N00004386",312,16,17,11,6,46,2,14,51,42,62,13,39,26
"N00004387",252,22,8,1,7,25,5,17,55,33,37,10,38,24
"N00004388",321,23,11,6,5,22,4,19,80,40,65,18,36,26
"N00004389",357,26,22,17,5,41,6,20,71,35,62,22,46,32
"N00004390",345,26,22,13,9,31,4,22,69,42,55,23,45,32
"N00004391",344,23,27,17,10,36,3,20,59,35,57,14,48,45
"N00004392",255,10,44,32,12,25,1,9,27,19,23,19,41,47
"N00004393",235,8,39,31,8,20,2,6,27,24,40,10,32,35
"N00004394",163,1,43,34,9,6,0,1,17,12,7,11,30,36
"N00004395",183,5,40,33,7,14,1,4,20,9,5,11,36,43
"N00004396",328,18,20,15,5,23,4,14,63,37,54,22,46,45
"N00004397",220,14,19,11,8,17,2,12,35,18,26,11,44,36
"N00004398",365,24,14,10,4,32,6,18,76,35,69,27,49,39
"N00004399",440,38,31,26,5,47,6,32,112,52,66,23,39,32
"N00004400",363,31,23,17,6,41,2,29,76,35,54,16,47,40
"N00004401",544,34,31,24,7,61,5,29,100,53,63,35,87,80
"N00004402",830,51,72,57,15,81,11,40,155,88,76,49,123,135
"N00004403",239,19,14,13,1,18,4,15,43,24,20,19,44,38
"N00004404",530,23,52,35,17,33,2,21,72,57,48,44,90,111
"N00004405",507,11,84,65,19,41,2,9,58,41,31,28,100,113
"N00004406",295,8,52,39,13,24,1,7,35,20,14,19,58,65
"N00004407",259,15,23,21,2,31,5,10,61,30,26,12,34,27
"N00004408",251,17,16,11,5,22,4,13,60,27,21,17,37,34
"N00004409",307,32,18,12,6,45,7,25,88,29,25,7,37,26
"N00004410",478,29,46,31,15,59,7,22,101,43,52,25,60,63
"N00004411",353,19,34,22,12,43,7,12,70,28,39,23,48,49
"N00004412",308,18,37,31,6,30,2,16,51,34,32,12,54,40
"N00004413",154,4,16,13,3,10,1,3,38,15,13,9,27,22
"N00004414",119,6,15,11,4,7,1,5,25,11,10,9,20,16
"N00004415",744,17,145,105,40,63,5,12,73,53,37,48,136,172
"N00004416",422,18,57,41,16,36,1,17,73,25,32,40,75,66
"N00004417",363,23,27,20,7,44,3,20,65,37,63,28,36,40
"N00004418",375,15,18,17,1,32,2,13,68,28,99,19,42,54
"N00004419",335,22,21,12,9,29,4,18,67,32,54,12,52,46
"N00004420",371,21,20,17,3,42,6,15,71,49,70,22,36,40
"N00004421",267,16,21,16,5,25,3,13,44,30,39,15,31,46
"N00004422",336,16,27,21,6,30,2,14,44,31,74,16,42,56
"N00004423",324,16,30,24,6,37,3,13,57,25,67,16,33,43
"N00004424",291,16,48,37,11,22,2,14,38,25,50,18,31,43
"N00004425",360,14,30,18,12,35,2,12,58,34,57,24,51,57
"N00004426",337,16,31,23,8,26,4,12,47,31,84,25,38,39
"N00004427",283,11,36,26,10,43,3,8,36,18,57,14,40,28
"N00004428",295,20,20,15,5,32,2,18,48,27,68,15,28,37
"N00004429",362,21,22,20,2,46,5,16,58,47,67,25,41,35
"N00004430",370,25,42,31,11,41,5,20,68,32,58,18,39,47
"N00004431",331,21,28,18,10,39,1,20,48,32,66,21,33,43
"N00004432",93,3,22,14,8,1,1,2,9,5,12,4,10,27
"N00004433",440,20,41,30,11,40,4,16,63,52,29,32,91,72
"N00004434",312,15,23,14,9,21,1,14,39,23,33,27,73,58
"N00004435",241,18,10,6,4,13,1,17,48,29,20,26,38,39
"N00004436",294,17,27,23,4,28,1,16,63,21,61,17,27,33
"N00004437",229,7,27,20,7,26,2,5,45,21,31,8,37,27
"N00004438",389,25,34,24,10,48,3,22,74,29,80,21,39,39
"N00004439",411,30,44,37,7,41,5,25,67,33,65,17,47,67
"N00004440",369,16,23,17,6,54,0,16,62,43,72,14,41,44
"N00004441",408,21,20,16,4,49,1,20,68,33,79,23,57,58
"N00004442",378,23,30,23,7,34,6,17,57,40,79,19,48,48
"N00004443",414,25,20,14,6,41,6,19,94,49,81,17,47,40
"N00004444",222,10,34,27,7,15,1,9,25,26,40,11,32,29
"N00004445",271,19,23,16,7,9,1,18,51,30,47,29,34,29
"N00004446",335,14,24,17,7,28,4,10,50,34,26,35,63,61
"N00004447",259,10,28,13,15,22,3,7,30,25,19,22,59,44
"N00004448",370,23,19,17,2,29,6,17,55,49,44,36,59,56
"N00004449",322,17,27,18,9,37,5,12,49,29,39,29,43,52
"N00004450",285,14,16,14,2,23,3,11,42,30,47,23,48,42
"N00004451",428,28,41,29,12,41,3,25,58,38,77,25,54,66
"N00004452",214,4,36,24,12,33,1,3,13,15,14,18,37,44
"N00004453",224,1,42,25,17,22,1,0,22,20,7,19,45,46
"N00004454",196,6,34,26,8,24,0,6,22,17,5,12,33,43
"N00004455",229,0,43,35,8,20,0,0,17,17,8,12,54,58
"N00004456",225,3,44,32,12,15,0,3,18,17,17,16,40,55
"N00004457",227,8,26,14,12,21,0,8,36,23,11,16,38,48
"N00004458",230,7,15,10,5,29,0,7,36,21,41,11,30,40
"N00004459",599,17,102,74,28,56,2,15,55,56,72,34,99,108
"N00004460",175,2,28,19,9,11,2,0,8,15,10,10,51,40
"N00004461",298,8,55,44,11,21,1,7,28,23,27,15,52,69
"N00004462",231,2,47,38,9,18,0,2,22,13,17,16,30,66
"N00004463",337,16,26,19,7,36,5,11,45,30,70,22,47,45
"N00004464",293,5,51,33,18,27,0,5,19,26,32,14,57,62
"N00004465",339,19,27,21,6,35,2,17,48,29,62,20,48,51
"N00004466",285,9,22,17,5,21,2,7,31,26,37,21,50,68
"N00004467",301,11,20,16,4,24,0,11,40,27,64,17,52,46
"N00004468",356,11,27,22,5,29,4,7,62,41,65,15,55,51
"N00004469",265,14,27,18,9,20,2,12,43,24,25,17,39,56
"N00004470",211,8,41,29,12,12,2,6,13,11,20,9,23,74
"N00004471",298,10,23,17,6,24,0,10,35,30,57,17,53,49
"N00004472",544,32,44,33,11,62,5,27,90,42,101,27,61,85
"N00004473",241,10,23,15,8,27,4,6,34,16,49,12,34,36
"N00004474",625,20,130,90,40,39,5,15,60,45,23,51,103,154
"N00004475",179,2,57,44,13,15,0,2,9,13,9,7,28,39
"N00004476",205,4,62,47,15,16,1,3,10,10,10,13,33,47
"N00004477",222,4,52,37,15,28,2,2,19,4,11,12,37,55
"N00004478",415,8,37,27,10,38,3,5,61,33,77,27,73,61
"N00004479",392,14,33,14,19,36,1,13,62,44,45,20,59,79
"N00004480",345,16,28,16,12,41,5,11,62,32,42,20,49,55
"N00004481",398,19,30,16,14,39,4,15,63,39,55,26,56,71
"N00004482",229,5,32,24,8,22,0,5,27,21,17,16,34,55
"N00004483",259,2,68,46,22,19,0,2,14,16,14,17,40,69
"N00004484",433,13,57,39,18,38,3,10,60,46,66,29,56,68
"N00004485",321,6,53,46,7,40,0,6,33,21,53,16,39,60
"N00004486",243,3,59,46,13,27,0,3,16,15,17,12,41,53
"N00004487",308,16,33,21,12,35,3,13,34,25,57,14,43,51
"N00004488",327,10,37,26,11,24,2,8,39,34,68,15,52,48
"N00004489",246,6,34,26,8,18,1,5,25,27,40,13,39,44
"N00004490",362,14,35,24,11,37,1,13,60,39,43,20,55,59
"N00004491",249,4,48,27,21,16,2,2,23,23,28,20,41,46
"N00004492",232,15,19,10,9,16,1,14,38,26,42,12,36,28
"N00004493",312,10,19,9,10,25,2,8,60,37,39,23,55,44
"N00004494",216,0,44,32,12,16,0,0,16,16,16,11,44,53
"N00004495",234,6,48,33,15,16,1,5,25,10,13,16,49,51
"N00004496",643,44,66,49,17,56,8,36,147,67,77,43,87,56
"N00004497",294,13,47,32,15,24,4,9,39,28,24,24,36,59
"N00004498",1069,55,117,74,43,113,14,41,204,118,116,63,166,117
"N00004499",155,7,25,23,2,7,2,5,18,7,12,12,35,32
"N00004500",139,4,41,23,18,11,0,4,8,7,10,6,27,25
"N00004501",319,17,17,12,5,37,1,16,53,33,55,22,40,45
"N00004502",220,7,23,18,5,22,0,7,31,18,59,6,21,33
"N00004503",270,13,15,12,3,31,1,12,49,25,59,17,29,32
"N00004504",200,6,24,14,10,20,1,5,23,13,35,14,32,33
"N00004505",298,18,19,13,6,21,3,15,41,30,55,28,47,39
"N00004506",259,25,25,16,9,21,8,17,35,25,34,20,32,42
"N00004507",221,7,17,11,6,16,2,5,20,29,12,15,41,64
"N00004508",492,25,54,38,16,40,7,18,63,36,54,35,79,106
"N00004509",203,11,24,16,8,19,1,10,40,17,17,10,31,34
"N00004510",246,5,31,24,7,17,2,3,26,18,21,23,45,60
"N00004511",150,7,21,12,9,6,0,7,20,18,11,10,23,34
"N00004512",278,17,17,10,7,18,3,14,35,29,38,20,39,65
"N00004513",326,11,27,24,3,34,3,8,43,37,43,14,55,62
"N00004514",440,31,33,20,13,42,6,25,77,66,51,32,59,49
"N00004515",283,18,12,10,2,27,3,15,50,44,50,21,34,27
"N00004516",288,11,28,23,5,20,1,10,38,27,50,21,42,51
"N00004517",283,10,15,10,5,15,0,10,54,32,59,12,34,52
"N00004518",206,6,22,11,11,15,0,6,24,25,12,13,46,43
"N00004519",232,5,51,30,21,26,1,4,18,16,10,17,40,49
"N00004520",794,41,54,39,15,86,17,24,142,102,61,53,137,118
"N00004521",254,8,37,27,10,25,2,6,49,15,20,9,35,56
"N00004522",275,8,21,14,7,36,1,7,51,28,22,16,46,47
"N00004523",271,16,23,16,7,27,5,11,49,32,21,25,42,36
"N00004524",177,5,17,13,4,15,1,4,32,12,11,12,38,35
"N00004525",311,20,14,9,5,27,6,14,73,44,29,24,40,40
"N00004526",317,17,17,14,3,21,5,12,53,31,84,28,36,30
"N00004527",246,4,29,21,8,20,0,4,25,16,34,18,40,60
"N00004528",332,11,24,12,12,31,2,9,45,27,56,23,53,62
"N00004529",227,8,22,12,10,20,0,8,31,20,35,19,31,41
"N00004530",260,11,40,35,5,24,3,8,27,22,43,11,34,48
"N00004531",287,9,27,15,12,31,1,8,41,40,39,12,46,42
"N00004532",279,16,20,12,8,30,2,14,54,39,31,15,39,35
"N00004533",239,2,40,30,10,20,0,2,33,15,14,15,50,50
"N00004534",786,44,66,47,19,75,7,37,153,91,71,49,112,125
"N00004535",583,29,52,31,21,45,2,27,109,65,35,43,95,110
"N00004536",201,12,32,24,8,12,3,9,23,18,10,12,37,45
"N00004537",188,6,29,15,14,13,1,5,21,11,11,17,42,38
